martin_lev	martin_lev
kitana_baker	kitana_baker
george_dewhurst	george_dewhurst
zhang_ziyi	zhang_ziyi
stig_lasseby	stig_lasseby
li_lili	li_lili
bruce_lee	bruce_lee
frankie_chan	frankie_chan
christian_casadesus	christian_casadesus
michael_miu	michael_miu
ulf_palme	ulf_palme
bellan_roos	bellan_roos
lawson_butt	lawson_butt
fred_goodwins	fred_goodwins
ivy_lee_(actress)	ivy_lee_(actress)
naomi_chance	naomi_chance
feng_gong	feng_gong
hiroyuki_onoue	hiroyuki_onoue
alice_tzeng	alice_tzeng
zhao_lirong	zhao_lirong
priscelia_chan	priscelia_chan
alf_kjellin	alf_kjellin
anna_calder-marshall	anna_calder-marshall
min_tanaka	min_tanaka
christiane_delyne	christiane_delyne
tina_leung	tina_leung
yutaka_matsushige	yutaka_matsushige
li_xuejian	li_xuejian
masami_kikuchi	masami_kikuchi
masato_yamanouchi	masato_yamanouchi
jack_livesey	jack_livesey
greg_centauro	greg_centauro
chang_chen	chang_chen
ken_mitsuishi	ken_mitsuishi
mary_meade	mary_meade
ken_yamaguchi	ken_yamaguchi
curt_masreliez	curt_masreliez
charles_dullin	charles_dullin
ann-marie_gyllenspetz	ann-marie_gyllenspetz
colin_keith-johnston	colin_keith-johnston
brett_mycles	brett_mycles
dany_robin	dany_robin
susan_skipper	susan_skipper
jean_bradin	jean_bradin
belita	belita
daniel_duval	daniel_duval
griffith_jones_(actor)	griffith_jones_(actor)
danny_lopes	danny_lopes
yoshio_inaba	yoshio_inaba
muriel_aked	muriel_aked
kazumi_tanaka	kazumi_tanaka
walter_byron_(actor)	walter_byron_(actor)
gilly_coman	gilly_coman
martin_boddey	martin_boddey
dagmar_ebbesen	dagmar_ebbesen
john_shum	john_shum
waise_lee	waise_lee
bramwell_fletcher	bramwell_fletcher
wilber_pan	wilber_pan
guy_bellis	guy_bellis
sammi_cheng	sammi_cheng
yasmine_lafitte	yasmine_lafitte
stephy_tang	stephy_tang
nicky_wu	nicky_wu
junie_astor	junie_astor
leah_luv	leah_luv
norman_wooland	norman_wooland
sayoko_yamaguchi	sayoko_yamaguchi
marika_green	marika_green
geoffrey_beevers	geoffrey_beevers
terence_cooper	terence_cooper
daniel_wu	daniel_wu
emily_chu	emily_chu
richard_dolman	richard_dolman
kristina_adolphson	kristina_adolphson
sumiko_hidaka	sumiko_hidaka
simon_nash	simon_nash
rosalind_ayres	rosalind_ayres
kazuyuki_sogabe	kazuyuki_sogabe
tina_tyler	tina_tyler
brigitte_lin	brigitte_lin
philip_latham	philip_latham
jack_purvis_(actor)	jack_purvis_(actor)
ulf_johanson	ulf_johanson
barbara_cason	barbara_cason
lee_kang-sheng	lee_kang-sheng
george_relph	george_relph
jean_del_val	jean_del_val
gene_gerrard	gene_gerrard
yasuko_matsuyuki	yasuko_matsuyuki
cameron_hall_(actor)	cameron_hall_(actor)
bokuzen_hidari	bokuzen_hidari
shauna_grant	shauna_grant
teruyuki_kagawa	teruyuki_kagawa
miho_nikaido	miho_nikaido
wiktor_andersson	wiktor_andersson
zhang_jingchu	zhang_jingchu
richard_ng	richard_ng
bernard_lancret	bernard_lancret
lam_ching-ying	lam_ching-ying
chie_sawaguchi	chie_sawaguchi
tony_leung_ka-fai	tony_leung_ka-fai
frank_conroy_(actor)	frank_conroy_(actor)
bernard_campan	bernard_campan
georgia_king	georgia_king
fred_emney	fred_emney
alexander_field_(actor)	alexander_field_(actor)
hilda_bayley	hilda_bayley
mark_chao	mark_chao
hyapatia_lee	hyapatia_lee
jane_sherwin	jane_sherwin
fred_groves_(actor)	fred_groves_(actor)
ann-mari_adamsson	ann-mari_adamsson
miho_fujima	miho_fujima
jakob_eklund	jakob_eklund
joan_chen	joan_chen
annie_cruz	annie_cruz
hideko_yoshida	hideko_yoshida
michael_lonsdale	michael_lonsdale
germaine_michel	germaine_michel
inday_ba	inday_ba
belle_chrystall	belle_chrystall
ivy_ling_po	ivy_ling_po
ashley_blue	ashley_blue
jack_lambert_(british_actor)	jack_lambert_(british_actor)
minnie_rayner	minnie_rayner
yuriko_hanabusa	yuriko_hanabusa
karen_dior	karen_dior
flora_finch	flora_finch
tony_liu	tony_liu
cedric_smith_(actor)	cedric_smith_(actor)
guy_newall	guy_newall
sam_bernard	sam_bernard
thomas_heathcote	thomas_heathcote
dana_vespoli	dana_vespoli
athole_stewart	athole_stewart
ken_lo	ken_lo
keiko_takeshita	keiko_takeshita
masato_hagiwara	masato_hagiwara
megan_zheng	megan_zheng
svea_holst	svea_holst
amelia_shankley	amelia_shankley
terry_scully	terry_scully
harold_warrender	harold_warrender
stina_ekblad	stina_ekblad
bowie_wu	bowie_wu
yoyo_mung	yoyo_mung
morton_selten	morton_selten
zhao_tao	zhao_tao
eloy_azorin	eloy_azorin
kim_peacock	kim_peacock
jeff_stryker	jeff_stryker
monica_chan	monica_chan
jiang_wen	jiang_wen
anne-marie_brunius	anne-marie_brunius
terry_walsh_(actor)	terry_walsh_(actor)
natalie_tong	natalie_tong
yvonne_lim	yvonne_lim
liza_wang	liza_wang
eileen_percy	eileen_percy
leila_tong	leila_tong
josephine_siao	josephine_siao
evelyn_tan	evelyn_tan
hollie_stevens	hollie_stevens
marcel_bozzuffi	marcel_bozzuffi
tina_russell	tina_russell
nina_li_(actress)	nina_li_(actress)
josette_simon	josette_simon
philippe_volter	philippe_volter
richard_cooper_(actor)	richard_cooper_(actor)
joey_stefano	joey_stefano
wayne_chua	wayne_chua
chloe_jones	chloe_jones
nicholas_phipps	nicholas_phipps
sture_ericson	sture_ericson
elliot_ngok	elliot_ngok
isao_yamagata	isao_yamagata
ernest_butcher	ernest_butcher
sacha_alexander	sacha_alexander
michel_nastorg	michel_nastorg
roman_tam	roman_tam
eve_matheson	eve_matheson
cora_miao	cora_miao
gertan_klauber	gertan_klauber
alan_tam	alan_tam
gwei_lun-mei	gwei_lun-mei
isao_kimura	isao_kimura
kandi_barbour	kandi_barbour
beverly_lynne	beverly_lynne
paul_valentine	paul_valentine
doris_svedlund	doris_svedlund
emi_wakui	emi_wakui
dudley_foster	dudley_foster
kristina_wayborn	kristina_wayborn
kenny_bee	kenny_bee
michelle_yeoh	michelle_yeoh
coralie_trinh_thi	coralie_trinh_thi
karen_lancaume	karen_lancaume
julian_firth	julian_firth
felicia_tang	felicia_tang
arthur_margetson	arthur_margetson
stig_johanson	stig_johanson
joseph_tremain	joseph_tremain
dagmar_olsson	dagmar_olsson
ron_jeremy	ron_jeremy
onoe_shoroku_ii	onoe_shoroku_ii
dayo_wong	dayo_wong
katsuo_nakamura	katsuo_nakamura
megan_leigh	megan_leigh
kenneth_kent	kenneth_kent
jimmy_lin	jimmy_lin
chi_chi_larue	chi_chi_larue
kunie_tanaka	kunie_tanaka
ernst_eklund_(actor)	ernst_eklund_(actor)
david_oxley	david_oxley
franklin_dyall	franklin_dyall
annalisa_ericson	annalisa_ericson
stephen_chow	stephen_chow
john_hollis	john_hollis
mimi_lo	mimi_lo
sasha_gabor	sasha_gabor
fiona_xie	fiona_xie
vincent_zhao	vincent_zhao
sydney_bromley	sydney_bromley
christopher_doyle	christopher_doyle
patrick_chesnais	patrick_chesnais
wallace_chung	wallace_chung
akiko_wakabayashi	akiko_wakabayashi
eitaro_ozawa	eitaro_ozawa
hiroshi_tsuburaya	hiroshi_tsuburaya
rocco_siffredi	rocco_siffredi
anna_lindahl	anna_lindahl
kim_anderzon	kim_anderzon
emil_forselius	emil_forselius
scott_o'hara	scott_o'hara
hideo_murota	hideo_murota
kitty_foxx	kitty_foxx
mickey_g.	mickey_g.
nenji_kobayashi	nenji_kobayashi
sonia_holm	sonia_holm
madeleine_renaud	madeleine_renaud
nils_poppe	nils_poppe
henry_bergman	henry_bergman
chor_yuen	chor_yuen
bionca	bionca
luc_andrieux	luc_andrieux
rena_tanaka	rena_tanaka
clifford_mollison	clifford_mollison
alan_tern	alan_tern
kelly_chen	kelly_chen
takako_tokiwa	takako_tokiwa
gao_yuanyuan	gao_yuanyuan
tania_mallet	tania_mallet
jean-louis_richard	jean-louis_richard
arletta_duncan	arletta_duncan
junko_miyashita	junko_miyashita
isabelle_mergault	isabelle_mergault
sarah_patterson	sarah_patterson
ayako_wakao	ayako_wakao
jacquie_lyn	jacquie_lyn
tor_isedal	tor_isedal
mieko_harada	mieko_harada
ittoku_kishibe	ittoku_kishibe
herbert_bunston	herbert_bunston
jennifer_daniel	jennifer_daniel
marcia_warren	marcia_warren
barbara_couper	barbara_couper
edward_lexy	edward_lexy
fernand_charpin	fernand_charpin
wallas_eaton	wallas_eaton
joan_maude	joan_maude
michiyo_aratama	michiyo_aratama
c.v._france	c.v._france
ulla_akselson	ulla_akselson
keiran_lee	keiran_lee
keiko_kishi	keiko_kishi
donald_eccles	donald_eccles
sunrise_adams	sunrise_adams
vivienne_chatterton	vivienne_chatterton
zhang_hanyu	zhang_hanyu
sybil_arundale	sybil_arundale
xu_jinglei	xu_jinglei
jullan_kindahl	jullan_kindahl
timmy_hung	timmy_hung
norman_page	norman_page
show_luo	show_luo
mikio_narita	mikio_narita
race_wong	race_wong
herschel_savage	herschel_savage
zhang_guoli	zhang_guoli
kika_markham	kika_markham
so_yamamura	so_yamamura
kent_tong	kent_tong
suzy_mandel	suzy_mandel
dicky_cheung	dicky_cheung
gunnar_olsson_(actor)	gunnar_olsson_(actor)
chen_daoming	chen_daoming
noriko_tatsumi	noriko_tatsumi
erik_strandmark	erik_strandmark
huang_bo	huang_bo
giani_esposito	giani_esposito
daniela_amavia	daniela_amavia
uschi_digard	uschi_digard
philippa_gail	philippa_gail
peter_madden_(actor)	peter_madden_(actor)
hou_yaowen	hou_yaowen
tomio_aoki	tomio_aoki
peter_swanwick	peter_swanwick
allan_wu	allan_wu
signe_wirff	signe_wirff
linda_lovelace	linda_lovelace
anne_crawford	anne_crawford
vera_day	vera_day
hiromi_nagasaku	hiromi_nagasaku
jack_wrangler	jack_wrangler
marcel_vibert	marcel_vibert
ellen_pollock	ellen_pollock
rayson_tan	rayson_tan
gillian_chung	gillian_chung
erik_rhodes_(pornographic_actor)	erik_rhodes_(pornographic_actor)
rebecca_brooke	rebecca_brooke
julie_strain	julie_strain
zena_marshall	zena_marshall
hugh_cross	hugh_cross
tsui_hark	tsui_hark
sylvia_chang	sylvia_chang
louis_fan	louis_fan
adam_cheng	adam_cheng
evan_seinfeld	evan_seinfeld
alexandra_silk	alexandra_silk
ichiro_sugai	ichiro_sugai
pierre_etchepare	pierre_etchepare
frida_hallgren	frida_hallgren
nina_hartley	nina_hartley
angelica_lee	angelica_lee
inga_gill	inga_gill
michel_galabru	michel_galabru
carl_forgione	carl_forgione
charles_lloyd-pack	charles_lloyd-pack
piers_flint-shipman	piers_flint-shipman
nils_hallberg	nils_hallberg
elof_ahrle	elof_ahrle
maho_toyota	maho_toyota
vincent_kok	vincent_kok
alec_su	alec_su
jeanne_de_casalis	jeanne_de_casalis
jasmine_byrne	jasmine_byrne
majandra_delfino	majandra_delfino
yang_mi	yang_mi
billy_chow	billy_chow
veronica_carlson	veronica_carlson
lila_leslie	lila_leslie
morgan_andersson	morgan_andersson
chieko_aioi	chieko_aioi
susan_stephen	susan_stephen
cecil_humphreys	cecil_humphreys
pauline_chan_bo-lin	pauline_chan_bo-lin
osamu_takizawa	osamu_takizawa
michelle_ye	michelle_ye
justin_deas	justin_deas
akira_emoto	akira_emoto
philippe_nahon	philippe_nahon
roland_hedlund	roland_hedlund
tsunehiko_watase	tsunehiko_watase
sunny_chan	sunny_chan
charlie_brill	charlie_brill
ann_casson	ann_casson
davina_craig	davina_craig
power_chan	power_chan
ella_koon	ella_koon
david_lloyd_meredith	david_lloyd_meredith
carrie_ng	carrie_ng
tsutomu_yamazaki	tsutomu_yamazaki
sven-eric_gamble	sven-eric_gamble
cathryn_harrison	cathryn_harrison
kate_hardie	kate_hardie
dagny_lind	dagny_lind
matt_chow	matt_chow
steve_shaw_(actor)	steve_shaw_(actor)
stina_berg	stina_berg
rebecca_saire	rebecca_saire
william_austin_(actor)	william_austin_(actor)
eleanor_summerfield	eleanor_summerfield
hinako_saeki	hinako_saeki
william_marlowe	william_marlowe
gallen_lo	gallen_lo
naoki_sugiura	naoki_sugiura
michiyo_okusu	michiyo_okusu
sami_frey	sami_frey
skye_bennett	skye_bennett
masaaki_tsukada	masaaki_tsukada
greta_almroth	greta_almroth
madeleine_milhaud	madeleine_milhaud
clifford_rose	clifford_rose
jenny_alpha	jenny_alpha
fumie_kashiyama	fumie_kashiyama
richard_low	richard_low
yu_nan	yu_nan
declan_mulholland	declan_mulholland
toivo_pawlo	toivo_pawlo
isabelle_nanty	isabelle_nanty
aaron_kwok	aaron_kwok
saori_hara	saori_hara
yngve_nordwall	yngve_nordwall
alien_sun	alien_sun
amber_kuo	amber_kuo
ingrid_backlin	ingrid_backlin
yoshiko_tanaka	yoshiko_tanaka
pai_ping-ping	pai_ping-ping
nicholas_tse	nicholas_tse
nao_saejima	nao_saejima
paul_chung	paul_chung
eric_stryker	eric_stryker
robert_urquhart_(actor)	robert_urquhart_(actor)
amy_dalby	amy_dalby
yu_lan	yu_lan
miki_yeung	miki_yeung
lecatte-folleville	lecatte-folleville
wilson_yip	wilson_yip
sayuri_yamauchi	sayuri_yamauchi
stig_olin	stig_olin
jack_neo	jack_neo
wang_baoqiang	wang_baoqiang
michelle_bauer	michelle_bauer
jean_worms	jean_worms
jenny_tomasin	jenny_tomasin
michael_graham_cox	michael_graham_cox
charles_cooper_(actor)	charles_cooper_(actor)
carlo_gabriel_nero	carlo_gabriel_nero
jonathan_morgan_(director)	jonathan_morgan_(director)
viola_compton	viola_compton
helga_thomas	helga_thomas
hou_baolin	hou_baolin
kristal_tin	kristal_tin
mandy_chiang	mandy_chiang
jana_carpenter	jana_carpenter
kim_hartman	kim_hartman
ravi_kapoor	ravi_kapoor
jeremy_spenser	jeremy_spenser
taeko_nakanishi	taeko_nakanishi
umewaka_minoru_i	umewaka_minoru_i
yu_rongguang	yu_rongguang
keiko_toda	keiko_toda
betty_ann_davies	betty_ann_davies
pierre_palau	pierre_palau
naomi_tani	naomi_tani
henri_attal	henri_attal
eiko_masuyama	eiko_masuyama
claude_gensac	claude_gensac
ronald_cheng	ronald_cheng
gabrielle_robinne	gabrielle_robinne
ryo_kase	ryo_kase
susan_shaw	susan_shaw
pihla_viitala	pihla_viitala
mary_kerridge	mary_kerridge
mario_montez	mario_montez
ryosuke_kagawa	ryosuke_kagawa
sandy_lam	sandy_lam
ben_warriss	ben_warriss
song_wenfei	song_wenfei
alfred_hickman	alfred_hickman
kenji_ebisawa	kenji_ebisawa
james_wong_(lyricist)	james_wong_(lyricist)
chow_yun-fat	chow_yun-fat
marc_de_jonge	marc_de_jonge
jun_fubuki	jun_fubuki
keve_hjelm	keve_hjelm
kwan_hoi-san	kwan_hoi-san
reine_brynolfsson	reine_brynolfsson
ambrosine_phillpotts	ambrosine_phillpotts
scott_nails	scott_nails
keiko_takahashi	keiko_takahashi
jean_davy	jean_davy
langhorn_burton	langhorn_burton
gillian_blake	gillian_blake
nozomi_momoi	nozomi_momoi
yammie_lam	yammie_lam
jun_murakami	jun_murakami
kirsten_cooke	kirsten_cooke
yurika_hino	yurika_hino
suzanne_dalbert	suzanne_dalbert
kazue_fukiishi	kazue_fukiishi
jean_boht	jean_boht
roger_blin	roger_blin
kumiko_aso	kumiko_aso
jean_desailly	jean_desailly
daniel_chatto	daniel_chatto
christine_ng	christine_ng
janne_carlsson	janne_carlsson
joe_melia	joe_melia
fridolf_rhudin	fridolf_rhudin
stirling_gallacher	stirling_gallacher
bao_guo'an	bao_guo'an
stella_farentino	stella_farentino
richenda_carey	richenda_carey
hu_die	hu_die
stuart_burge	stuart_burge
yoko_moriguchi	yoko_moriguchi
thomy_bourdelle	thomy_bourdelle
jack_melford	jack_melford
jacklyn_wu	jacklyn_wu
dong_jie	dong_jie
keith_pyott	keith_pyott
shaun_chen	shaun_chen
roy_herrick	roy_herrick
esther_sandoval	esther_sandoval
yoichi_numata	yoichi_numata
rolf_sohlman	rolf_sohlman
buck_adams	buck_adams
kwan_tak-hing	kwan_tak-hing
carl-axel_heiknert	carl-axel_heiknert
daphne_heard	daphne_heard
juliet_anderson	juliet_anderson
eiko_koike	eiko_koike
alana_evans	alana_evans
hung_sin-nui	hung_sin-nui
jennifer_rhodes	jennifer_rhodes
valda_setterfield	valda_setterfield
peter_bull	peter_bull
ruthie_henshall	ruthie_henshall
may_lo	may_lo
bo_brundin	bo_brundin
lawrence_chou	lawrence_chou
michael_lucas_(director)	michael_lucas_(director)
georg_funkquist	georg_funkquist
eiji_okuda	eiji_okuda
zhang_yimou	zhang_yimou
jamie_gillis	jamie_gillis
takayuki_yamada	takayuki_yamada
vivian_wu	vivian_wu
jimmy_nah	jimmy_nah
mona_geijer-falkner	mona_geijer-falkner
jade_leung	jade_leung
birger_lensander	birger_lensander
genie_chuo	genie_chuo
andy_lau	andy_lau
denise_ho	denise_ho
theresa_fu	theresa_fu
wu_ma	wu_ma
jewel_de'nyle	jewel_de'nyle
nick_cheung	nick_cheung
william_san	william_san
toby_leung	toby_leung
anna-lisa_baude	anna-lisa_baude
roy_chiao	roy_chiao
richard_mayes	richard_mayes
karena_lam	karena_lam
john_garrick	john_garrick
barbara_yung	barbara_yung
max_mok	max_mok
kevin_cheng	kevin_cheng
erik_hell	erik_hell
marcus_london	marcus_london
camilla_sparv	camilla_sparv
brewster_mason	brewster_mason
masaya_kato	masaya_kato
john_hewer	john_hewer
cherrie_ying	cherrie_ying
anna_palk	anna_palk
mitsuki_tanimura	mitsuki_tanimura
noel_coleman	noel_coleman
mimi_nelson	mimi_nelson
sandrine_kiberlain	sandrine_kiberlain
philip_stainton	philip_stainton
marcelle_chantal	marcelle_chantal
david_buck	david_buck
walter_hudd	walter_hudd
rodney_diak	rodney_diak
jiang_wu	jiang_wu
emily_fitzroy	emily_fitzroy
ted_thin_elk	ted_thin_elk
bai_hong	bai_hong
kathy_chow	kathy_chow
isabelle_corey	isabelle_corey
ken_mitsuda	ken_mitsuda
gerald_ames	gerald_ames
tetsushi_tanaka	tetsushi_tanaka
graham_pountney	graham_pountney
hiroshi_mikami	hiroshi_mikami
mark_cheng	mark_cheng
chingmy_yau	chingmy_yau
tutta_rolf	tutta_rolf
jia_hongsheng	jia_hongsheng
alysson_paradis	alysson_paradis
liu_yifei	liu_yifei
maggie_lau	maggie_lau
joyce_bland	joyce_bland
yasuhisa_furuhara	yasuhisa_furuhara
cyril_luckham	cyril_luckham
kayoko_kishimoto	kayoko_kishimoto
robert_moor	robert_moor
madison_stone	madison_stone
eric_barclay	eric_barclay
jean-baptiste_nicolet	jean-baptiste_nicolet
jane_welsh	jane_welsh
g.e.m._(singer)	g.e.m._(singer)
jon_dough	jon_dough
claude_maki	claude_maki
richard_dillane	richard_dillane
paul_bazely	paul_bazely
janet_henfrey	janet_henfrey
aubrey_mather	aubrey_mather
fay_helm	fay_helm
xavier_saint-macary	xavier_saint-macary
john_baskcomb	john_baskcomb
sam_costa	sam_costa
felix_wong	felix_wong
dennis_king	dennis_king
angela_chang	angela_chang
john_moulder-brown	john_moulder-brown
agda_helin	agda_helin
sune_mangs	sune_mangs
birgitta_valberg	birgitta_valberg
zeffie_tilbury	zeffie_tilbury
bunjaku_han	bunjaku_han
kazuo_hasegawa	kazuo_hasegawa
damian_lau	damian_lau
chapman_to	chapman_to
maud_forget	maud_forget
brenda_de_banzie	brenda_de_banzie
janine_lindemulder	janine_lindemulder
vincent_wong	vincent_wong
joanna_taylor	joanna_taylor
mona_seilitz	mona_seilitz
leslie_cheung	leslie_cheung
kaitlyn_ashley	kaitlyn_ashley
coco_lee	coco_lee
john_melin	john_melin
colette_darfeuil	colette_darfeuil
elliott_mason	elliott_mason
ian_collier	ian_collier
tera_wray	tera_wray
terence_yin	terence_yin
ricky_hui	ricky_hui
berta_hall	berta_hall
enid_stamp_taylor	enid_stamp_taylor
roger_legris	roger_legris
zhou_xun	zhou_xun
vahina_giocante	vahina_giocante
rosanne_wong	rosanne_wong
shinsuke_ashida	shinsuke_ashida
moses_chan	moses_chan
john_richardson_(actor)	john_richardson_(actor)
tora_teje	tora_teje
hans_ernback	hans_ernback
fiona_sit	fiona_sit
larry_taylor_(actor)	larry_taylor_(actor)
seiji_miyaguchi	seiji_miyaguchi
cecilia_cheung	cecilia_cheung
barry_wong	barry_wong
john_j._carney	john_j._carney
mayumi_ogawa	mayumi_ogawa
tomoko_yamaguchi	tomoko_yamaguchi
asami_sugiura	asami_sugiura
hilary_pritchard	hilary_pritchard
chen_hong_(actress)	chen_hong_(actress)
asa_akira	asa_akira
joan_rice	joan_rice
stacia_napierkowska	stacia_napierkowska
roger_duchesne	roger_duchesne
pu_cunxin	pu_cunxin
eiji_kanie	eiji_kanie
aino_taube	aino_taube
haley_paige	haley_paige
arthur_leslie	arthur_leslie
siqin_gaowa	siqin_gaowa
barbara_gott	barbara_gott
leslie_graves	leslie_graves
brian_nissen	brian_nissen
stephen_clancy_hill	stephen_clancy_hill
rosamund_kwan	rosamund_kwan
ulla_jacobsson	ulla_jacobsson
satomi_kobayashi	satomi_kobayashi
linda_hardy	linda_hardy
jean_marchat	jean_marchat
vincent_winter	vincent_winter
gloria_leonard	gloria_leonard
magnus_kesster	magnus_kesster
brian_miller_(actor)	brian_miller_(actor)
vivian_hsu	vivian_hsu
edward_atterton	edward_atterton
monique_demoan	monique_demoan
stephanie_che	stephanie_che
pan_lingling	pan_lingling
zhu_xu	zhu_xu
joe_duttine	joe_duttine
annu_mari	annu_mari
bengt_djurberg	bengt_djurberg
kermit_love	kermit_love
kenneth_tsang	kenneth_tsang
paula_shaw	paula_shaw
mr._marcus	mr._marcus
huang_yiliang	huang_yiliang
megumi_okina	megumi_okina
sun_ma_sze_tsang	sun_ma_sze_tsang
katsuhisa_namase	katsuhisa_namase
guy_bedos	guy_bedos
faith_brook	faith_brook
sibelle_hu	sibelle_hu
peter_lindgren_(actor)	peter_lindgren_(actor)
joseph_a._bennett	joseph_a._bennett
hisashi_igawa	hisashi_igawa
jeremy_brock	jeremy_brock
marcel_maupi	marcel_maupi
georgina_spelvin	georgina_spelvin
anna_malle	anna_malle
shinichi_tsutsumi	shinichi_tsutsumi
christian_marin	christian_marin
yumi_shirakawa	yumi_shirakawa
richard_caldicot	richard_caldicot
nicholas_teo	nicholas_teo
rikiya_yasuoka	rikiya_yasuoka
jimmy_aubrey	jimmy_aubrey
yumi_takada	yumi_takada
chui_tien-you	chui_tien-you
nicole_sheridan	nicole_sheridan
hugh_sinclair_(actor)	hugh_sinclair_(actor)
romeo_tan	romeo_tan
christopher_godwin	christopher_godwin
louis_cheung	louis_cheung
bobby_troup	bobby_troup
fumio_watanabe	fumio_watanabe
paw_hee-ching	paw_hee-ching
belinda_hamnett	belinda_hamnett
takaaki_ishibashi	takaaki_ishibashi
eason_chan	eason_chan
joey_yung	joey_yung
charlene_choi	charlene_choi
hidetaka_yoshioka	hidetaka_yoshioka
ulf_larsson	ulf_larsson
louis_koo	louis_koo
mc_jin	mc_jin
chihiro_otsuka	chihiro_otsuka
sunny_leone	sunny_leone
ku_feng	ku_feng
martin_walker_(actor)	martin_walker_(actor)
georg_skarstedt	georg_skarstedt
lucien_guitry	lucien_guitry
anita_yuen	anita_yuen
allan_bohlin	allan_bohlin
lo_wei	lo_wei
zeng_huifen	zeng_huifen
john_deverell	john_deverell
tamara_lees	tamara_lees
lolo_ferrari	lolo_ferrari
sharla_cheung	sharla_cheung
lydia_shum	lydia_shum
saburo_date	saburo_date
jordan_chan	jordan_chan
robert_vattier	robert_vattier
karl-arne_holmsten	karl-arne_holmsten
frankie_lam	frankie_lam
zak_spears	zak_spears
marc_pickering	marc_pickering
charmaine_sheh	charmaine_sheh
arthur_young_(actor)	arthur_young_(actor)
roger_vincent	roger_vincent
james_grout	james_grout
britta_brunius	britta_brunius
guy_marchand	guy_marchand
masato_harada	masato_harada
bradford_thomas_wagner	bradford_thomas_wagner
yvonne_de_bray	yvonne_de_bray
julia_ann	julia_ann
arthur_bostrom	arthur_bostrom
kanako_fukaura	kanako_fukaura
lasse_krantz	lasse_krantz
george_lam	george_lam
gustaf_molander	gustaf_molander
alice_connor	alice_connor
johan_rabaeus	johan_rabaeus
nakamura_nakazo_i	nakamura_nakazo_i
yuen_wah	yuen_wah
shino_kakinuma	shino_kakinuma
jet_li	jet_li
miki_mizuno	miki_mizuno
charles_le_bargy	charles_le_bargy
ovidie	ovidie
meggie_albanesi	meggie_albanesi
anita_west	anita_west
mina_anwar	mina_anwar
gull_natorp	gull_natorp
birgit_tengroth	birgit_tengroth
peter_tilbury	peter_tilbury
sun_daolin	sun_daolin
jj_jia	jj_jia
roland_curram	roland_curram
kaho_minami	kaho_minami
tang_pik-wan	tang_pik-wan
liu_xiao_ling_tong	liu_xiao_ling_tong
ekin_cheng	ekin_cheng
yang_libing	yang_libing
denmei_suzuki	denmei_suzuki
fann_wong	fann_wong
george_fant	george_fant
michael_stefano	michael_stefano
kenny_doughty	kenny_doughty
tanya_lopert	tanya_lopert
john_glyn-jones	john_glyn-jones
krysti_lynn	krysti_lynn
victor_travers	victor_travers
wallace_lupino	wallace_lupino
hu_jun	hu_jun
julia_foster	julia_foster
joey_leung	joey_leung
vanness_wu	vanness_wu
shuji_kashiwabara	shuji_kashiwabara
wong_tin-lam	wong_tin-lam
mitsuko_mito	mitsuko_mito
tatsuya_fuji	tatsuya_fuji
george_kuwa	george_kuwa
lauritz_falk	lauritz_falk
hugh_pryse	hugh_pryse
hajime_hana	hajime_hana
frederick_burtwell	frederick_burtwell
martin_wyldeck	martin_wyldeck
charles_goldner	charles_goldner
takuzo_kawatani	takuzo_kawatani
marilyn_chambers	marilyn_chambers
cavan_kendall	cavan_kendall
wang_yumei	wang_yumei
ai_iijima	ai_iijima
sachiko_hidari	sachiko_hidari
jay_ashley	jay_ashley
eiji_okada	eiji_okada
kikko_matsuoka	kikko_matsuoka
sasha_grey	sasha_grey
stanley_caine	stanley_caine
hideki_ogihara	hideki_ogihara
eiko_ando	eiko_ando
komaki_kurihara	komaki_kurihara
anthony_hulme	anthony_hulme
lung_fong	lung_fong
jessica_drake	jessica_drake
chan_shen	chan_shen
claude_faraldo	claude_faraldo
john_marlborough_east	john_marlborough_east
lally_bowers	lally_bowers
nicholas_saputra	nicholas_saputra
carl-axel_elfving	carl-axel_elfving
gail_sheridan	gail_sheridan
katherine_locke	katherine_locke
bengt_logardt	bengt_logardt
irma_christenson	irma_christenson
ludde_gentzel	ludde_gentzel
samuel_le_bihan	samuel_le_bihan
vic_chou	vic_chou
maria_kawamura	maria_kawamura
rex_o'malley	rex_o'malley
nobuko_miyamoto	nobuko_miyamoto
bowie_lam	bowie_lam
li_bingbing	li_bingbing
ryo_hitomi	ryo_hitomi
yui_ichikawa	yui_ichikawa
stefani_morgan	stefani_morgan
barbara_new	barbara_new
john_bentley_(actor)	john_bentley_(actor)
frederick_culley	frederick_culley
chen_xiaoxu	chen_xiaoxu
elaine_yiu	elaine_yiu
margaretha_krook	margaretha_krook
ray_lui	ray_lui
zhou_xuan	zhou_xuan
gaby_stenberg	gaby_stenberg
jimmy_godden	jimmy_godden
claudia_claire	claudia_claire
kimberly_kane	kimberly_kane
mark_womack_(british_actor)	mark_womack_(british_actor)
gong_qiuxia	gong_qiuxia
ruby_lin	ruby_lin
francesca_le	francesca_le
hilda_spong	hilda_spong
dany_verissimo	dany_verissimo
jeffrey_lau	jeffrey_lau
birgitta_pettersson	birgitta_pettersson
koreya_senda	koreya_senda
anna_cropper	anna_cropper
shirley_kwan	shirley_kwan
francis_lister	francis_lister
tatsuo_yamada	tatsuo_yamada
hitomi_kuroki	hitomi_kuroki
jonas_karlsson	jonas_karlsson
bobby_hollander	bobby_hollander
katie_rolfsen	katie_rolfsen
helge_hagerman	helge_hagerman
sven_lindberg	sven_lindberg
edvin_adolphson	edvin_adolphson
chen_liping	chen_liping
suzy_prim	suzy_prim
everley_gregg	everley_gregg
lea_de_mae	lea_de_mae
stephen_fung	stephen_fung
jeremy_wilkin	jeremy_wilkin
teddy_robin	teddy_robin
karin_schubert	karin_schubert
bai_guang	bai_guang
qi_yuwu	qi_yuwu
etsushi_toyokawa	etsushi_toyokawa
mutsuko_sakura	mutsuko_sakura
abel_jacquin	abel_jacquin
henry_mollison	henry_mollison
yuriko_ishida	yuriko_ishida
naemi_briese	naemi_briese
helen_haye	helen_haye
john_ekman	john_ekman
a.e._coleby	a.e._coleby
kumiko_akiyoshi	kumiko_akiyoshi
marjorie_rhodes	marjorie_rhodes
michael_sharvell-martin	michael_sharvell-martin
paul_crauchet	paul_crauchet
reiko_kataoka	reiko_kataoka
chang_chen-yue	chang_chen-yue
stormy_daniels	stormy_daniels
teagan_presley	teagan_presley
kiwako_taichi	kiwako_taichi
chrissie_white	chrissie_white
bojan_westin	bojan_westin
david_king-wood	david_king-wood
wanda_curtis	wanda_curtis
dyanne_thorne	dyanne_thorne
chen_sicheng	chen_sicheng
chieko_honda	chieko_honda
jesse_jane	jesse_jane
rikard_wolff	rikard_wolff
jenaveve_jolie	jenaveve_jolie
simone_griffeth	simone_griffeth
jacqueline_sassard	jacqueline_sassard
rosanna_carter	rosanna_carter
karin_kavli	karin_kavli
shu_qi	shu_qi
chyna	chyna
christy_canyon	christy_canyon
melvil_poupaud	melvil_poupaud
mitsuaki_hoshino	mitsuaki_hoshino
tanya_hyde	tanya_hyde
ernest_sefton	ernest_sefton
sif_ruud	sif_ruud
teresa_mo	teresa_mo
ayumi_ito	ayumi_ito
sally_yeh	sally_yeh
halina_tam	halina_tam
chizuru_ikewaki	chizuru_ikewaki
helena_pickard	helena_pickard
akira_kubo	akira_kubo
lesley_wareing	lesley_wareing
maria_antonietta_beluzzi	maria_antonietta_beluzzi
john_turnbull_(actor)	john_turnbull_(actor)
william_hung	william_hung
lisa_s.	lisa_s.
jacques_gamblin	jacques_gamblin
taketoshi_naito	taketoshi_naito
asia_carrera	asia_carrera
jane_marken	jane_marken
xie_na	xie_na
evan_stone	evan_stone
patricia_maynard	patricia_maynard
filip_berg	filip_berg
john_welsh_(actor)	john_welsh_(actor)
kenix_kwok	kenix_kwok
robin_byrd	robin_byrd
sita_chan	sita_chan
zheng_junli	zheng_junli
taylor_st._claire	taylor_st._claire
isa_quensel	isa_quensel
john_paul_(actor)	john_paul_(actor)
lilian_bond	lilian_bond
junzaburo_ban	junzaburo_ban
chikage_awashima	chikage_awashima
hiroyuki_ikeuchi	hiroyuki_ikeuchi
kenji_matsuda	kenji_matsuda
shingo_tsurumi	shingo_tsurumi
moana_pozzi	moana_pozzi
kaoru_shimamura	kaoru_shimamura
roy_cheung	roy_cheung
harry_ahlin	harry_ahlin
yuan_muzhi	yuan_muzhi
bernard_le_coq	bernard_le_coq
jacques_fabbri	jacques_fabbri
roger_dutoit	roger_dutoit
valentine_tessier	valentine_tessier
morio_kazama	morio_kazama
mathilde_seigner	mathilde_seigner
candy_samples	candy_samples
hy_hazell	hy_hazell
dominique_davray	dominique_davray
manuel_ferrara	manuel_ferrara
alice_tissot	alice_tissot
steve_railsback	steve_railsback
bertil_anderberg	bertil_anderberg
lynn_lemay	lynn_lemay
paulina_james	paulina_james
xu_qing	xu_qing
corinne_alphen	corinne_alphen
carmen_luvana	carmen_luvana
beatrice_hsu	beatrice_hsu
arne_ragneborn	arne_ragneborn
reika_kirishima	reika_kirishima
denise_legeay	denise_legeay
yu_chenghui	yu_chenghui
kobe_tai	kobe_tai
justin_lo	justin_lo
huang_shengyi	huang_shengyi
yuen_biao	yuen_biao
audrey_hollander	audrey_hollander
armand_kaliz	armand_kaliz
akiji_kobayashi	akiji_kobayashi
marianne_denicourt	marianne_denicourt
julien_rassam	julien_rassam
arata_iura	arata_iura
tien_feng	tien_feng
wong_cho-lam	wong_cho-lam
derek_farr	derek_farr
karl_erik_flens	karl_erik_flens
huang_xiaoming	huang_xiaoming
arthur_malet	arthur_malet
michelle_goh	michelle_goh
angela_pan	angela_pan
kiichi_nakai	kiichi_nakai
rakuto_tochihara	rakuto_tochihara
micheline_dax	micheline_dax
manfred_wong	manfred_wong
kaku_takashina	kaku_takashina
denise_grey	denise_grey
takanori_jinnai	takanori_jinnai
julia_lockwood	julia_lockwood
jukichi_uno	jukichi_uno
jacky_cheung	jacky_cheung
jacky_cheung	jay_chou
britta_holmberg	britta_holmberg
richard_ainley	richard_ainley
james_stephenson	james_stephenson
aya_sugimoto	aya_sugimoto
arne_lindblad	arne_lindblad
india_fisher	india_fisher
jerry_yan	jerry_yan
philip_merivale	philip_merivale
jacques_duby	jacques_duby
anders_ek	anders_ek
oscar_ljung	oscar_ljung
wellington_a._playter	wellington_a._playter
barbro_kollberg	barbro_kollberg
yoshiko_kuga	yoshiko_kuga
bonnie_holiday	bonnie_holiday
gunnar_nielsen_(actor)	gunnar_nielsen_(actor)
edison_chen	edison_chen
colleen_brennan	colleen_brennan
nene_otsuka	nene_otsuka
chen_yunshang	chen_yunshang
raymond_lam	raymond_lam
bosco_wong	bosco_wong
yoshifumi_tajima	yoshifumi_tajima
donnie_yen	donnie_yen
martin_ljung	martin_ljung
ken_chu	ken_chu
chi_kuan-chun	chi_kuan-chun
georgann_johnson	georgann_johnson
li_xiaolu	li_xiaolu
zhao_wei	zhao_wei
erica_boyer	erica_boyer
darren_lim	darren_lim
joey_meng	joey_meng
gudrun_brost	gudrun_brost
hitomi_shiraishi	hitomi_shiraishi
fritha_goodey	fritha_goodey
tore_svennberg	tore_svennberg
georg_rydeberg	georg_rydeberg
russell_wong	russell_wong
gabriel_alw	gabriel_alw
alex_fong_(actor)	alex_fong_(actor)
lin_meijiao	lin_meijiao
bob_haymes	bob_haymes
xiang_yun	xiang_yun
eddie_axberg	eddie_axberg
charles_carson_(actor)	charles_carson_(actor)
ranko_hanai	ranko_hanai
yngve_gamlin	yngve_gamlin
jan_erik_lindqvist	jan_erik_lindqvist
zhang_fengyi	zhang_fengyi
muriel_frances_dana	muriel_frances_dana
chan_hung-lit	chan_hung-lit
joshua_ang	joshua_ang
per-axel_arosenius	per-axel_arosenius
albert_dupontel	albert_dupontel
toni_edgar-bruce	toni_edgar-bruce
rainie_yang	rainie_yang
teresa_carpio	teresa_carpio
ai_maeda_(voice_actress)	ai_maeda_(voice_actress)
gordon_lam	gordon_lam
david_gale_(actor)	david_gale_(actor)
pamela_green	pamela_green
jack_hobbs_(actor)	jack_hobbs_(actor)
hong_huifang	hong_huifang
jenny_tschernichin-larsson	jenny_tschernichin-larsson
judy_gunn	judy_gunn
deric_wan	deric_wan
dorris_bowdon	dorris_bowdon
alexandra_quinn	alexandra_quinn
kei_suma	kei_suma
ken_uehara	ken_uehara
teru_shimada	teru_shimada
bernard_blier	bernard_blier
lou_gish	lou_gish
jenny_tseng	jenny_tseng
julian_cheung	julian_cheung
stacey_tendeter	stacey_tendeter
roy_stewart	roy_stewart
jun_hamamura	jun_hamamura
winnie_lau	winnie_lau
noriko_sengoku	noriko_sengoku
marlene_willoughby	marlene_willoughby
jeanne_stuart	jeanne_stuart
miyuki_ueda	miyuki_ueda
tong_dawei	tong_dawei
charlie_hall_(actor)	charlie_hall_(actor)
sachiko_murase	sachiko_murase
bolo_yeung	bolo_yeung
gong_li	gong_li
collin_chou	collin_chou
toshiyuki_nagashima	toshiyuki_nagashima
katja_k	katja_k
roger_karl	roger_karl
kanako_mitsuhashi	kanako_mitsuhashi
holly_one	holly_one
samuel_hui	samuel_hui
nigel_barrie	nigel_barrie
gloria_yip	gloria_yip
xu_fan	xu_fan
bertha_belmore	bertha_belmore
kary_ng	kary_ng
jack_trevor	jack_trevor
toshiyuki_hosokawa	toshiyuki_hosokawa
brook_williams	brook_williams
josie_ho	josie_ho
johan_ulveson	johan_ulveson
hubert_gregg	hubert_gregg
masahiro_usui	masahiro_usui
kuranosuke_sasaki	kuranosuke_sasaki
pang_ho-cheung	pang_ho-cheung
tyrell_davis	tyrell_davis
paul_jesson	paul_jesson
annie_sprinkle	annie_sprinkle
patrick_tse	patrick_tse
sammy_leung	sammy_leung
wakin_chau	wakin_chau
fan_bingbing	fan_bingbing
shiho_fujimura	shiho_fujimura
joyzelle_joyner	joyzelle_joyner
beatrice_pons	beatrice_pons
daniel_emilfork	daniel_emilfork
muga_takewaki	muga_takewaki
ingrid_luterkort	ingrid_luterkort
princess_donna	princess_donna
john_lone	john_lone
marianne_aminoff	marianne_aminoff
takeshi_kaneshiro	takeshi_kaneshiro
diana_pang	diana_pang
alain_cuny	alain_cuny
jaime_chik	jaime_chik
jacques_charby	jacques_charby
yumika_hayashi	yumika_hayashi
jean_marsan	jean_marsan
kin_sugai	kin_sugai
kristy_yang	kristy_yang
douglas_seale	douglas_seale
birger_malmsten	birger_malmsten
danson_tang	danson_tang
andy_hui	andy_hui
don_knight_(actor)	don_knight_(actor)
masao_shimizu	masao_shimizu
trinity_loren	trinity_loren
takahiro_tamura	takahiro_tamura
minase_yashiro	minase_yashiro
tony_d'amario	tony_d'amario
barbro_flodquist	barbro_flodquist
bengt_ekerot	bengt_ekerot
mary_forbes	mary_forbes
shauna_macdonald	shauna_macdonald
james_deen	james_deen
michael_anderson,_jr.	michael_anderson,_jr.
seiichi_tanabe	seiichi_tanabe
eric_kot	eric_kot
charlene_tse	charlene_tse
casey_donovan_(actor)	casey_donovan_(actor)
charles_berling	charles_berling
billy_herrington	billy_herrington
lisa_lu	lisa_lu
leon_lai	leon_lai
tin_kai-man	tin_kai-man
cherie_chung	cherie_chung
sture_lagerwall	sture_lagerwall
alec_b._francis	alec_b._francis
douglas_simmonds	douglas_simmonds
kaoru_yachigusa	kaoru_yachigusa
wayne_lai	wayne_lai
marta_romero	marta_romero
vanessa_del_rio	vanessa_del_rio
hugh_buckler	hugh_buckler
ma_sanli	ma_sanli
yoshinori_okada	yoshinori_okada
rose_stradner	rose_stradner
michel_auclair	michel_auclair
paulette_noizeux	paulette_noizeux
hampe_faustman	hampe_faustman
shigeru_muroi	shigeru_muroi
drusilla_wills	drusilla_wills
mark_kingston	mark_kingston
kurt_marshall	kurt_marshall
shun_sugata	shun_sugata
nanako_matsushima	nanako_matsushima
huang_wenyong	huang_wenyong
ken_yamauchi	ken_yamauchi
faye_wong	faye_wong
karen_mok	karen_mok
janet_dibley	janet_dibley
anita_mui	jacky_cheung
anita_mui	alan_tam
anita_mui	hacken_lee
anita_mui	anita_mui
henry_o	henry_o
nobuo_kaneko	nobuo_kaneko
william_snape	william_snape
roger_kwok	roger_kwok
william_so	william_so
adolf_jahr	adolf_jahr
john_witty	john_witty
feng_xiaogang	feng_xiaogang
sarah-jane_potts	sarah-jane_potts
annie_liu	annie_liu
kayo_matsuo	kayo_matsuo
sadako_sawamura	sadako_sawamura
bryan_leung	bryan_leung
jia_nailiang	jia_nailiang
qin_yi	qin_yi
johnny_sekka	johnny_sekka
edmund_chen	edmund_chen
arthur_rigby_(actor)	arthur_rigby_(actor)
roddy_maude-roxby	roddy_maude-roxby
lo_lieh	lo_lieh
ning_jing	ning_jing
daniel_chan	daniel_chan
shelagh_fraser	shelagh_fraser
leslie_bradley	leslie_bradley
masato_furuoya	masato_furuoya
ai_kobayashi	ai_kobayashi
segol_mann	segol_mann
nobuo_nakamura	nobuo_nakamura
rene_bond	rene_bond
margaret_lacey	margaret_lacey
caroline_carver_(actor)	caroline_carver_(actor)
geraldine_o'rawe	geraldine_o'rawe
alan_tang	alan_tang
stanley_logan	stanley_logan
jay_chou	jay_chou
wu_yingyin	wu_yingyin
paul_sorensen	paul_sorensen
tera_patrick	tera_patrick
barbie_hsu	barbie_hsu
jinpachi_nezu	jinpachi_nezu
hilton_edwards	hilton_edwards
alexander_fu_sheng	alexander_fu_sheng
maggie_cheung	maggie_cheung
julie_cox	julie_cox
david_horovitch	david_horovitch
zhang_yang_(director)	zhang_yang_(director)
sven_holmberg	sven_holmberg
kitten_natividad	kitten_natividad
yoshino_kimura	yoshino_kimura
sandra_payne	sandra_payne
macy_chan	macy_chan
ilona_staller	ilona_staller
terri_kwan	terri_kwan
hiroyuki_nagato	hiroyuki_nagato
winston_chao	winston_chao
hou_hsiao-hsien	hou_hsiao-hsien
honoka	honoka
natalis_chan	natalis_chan
barbara_dare	barbara_dare
gigi_leung	gigi_leung
wong_li-lin	wong_li-lin
andreas_wilson	andreas_wilson
lymari_nadal	lymari_nadal
karen_mayo-chandler	karen_mayo-chandler
gordon_liu	gordon_liu
nora_miao	nora_miao
ann-sofie_kylin	ann-sofie_kylin
akemi_okamura	akemi_okamura
minoru_chiaki	minoru_chiaki
shakira_caine	shakira_caine
yang_lina	yang_lina
ben_webster_(actor)	ben_webster_(actor)
lillian_zuckerman	lillian_zuckerman
marguerite_pierry	marguerite_pierry
joan_kemp-welch	joan_kemp-welch
max_maxudian	max_maxudian
zhang_yuqi	zhang_yuqi
cavan_clerkin	cavan_clerkin
derek_tsang	derek_tsang
chesty_morgan	chesty_morgan
vincent_lindon	vincent_lindon
ann_bridgewater	ann_bridgewater
athena_chu	athena_chu
hung_yan-yan	hung_yan-yan
masayuki_mori_(actor)	masayuki_mori_(actor)
anders_henrikson	anders_henrikson
yuko_kobayashi	yuko_kobayashi
charlton_heston	charlton_heston
yoko_tsukasa	yoko_tsukasa
cyndi_wang	cyndi_wang
mavis_fan	mavis_fan
kazuko_yanaga	kazuko_yanaga
pierre_png	pierre_png
yam_kim-fai	yam_kim-fai
lin_feng-jiao	lin_feng-jiao
jacques_herlin	jacques_herlin
simon_lack	simon_lack
cheung_tat-ming	cheung_tat-ming
gerd_hagman	gerd_hagman
miki_sugimoto	miki_sugimoto
shinobu_nakayama	shinobu_nakayama
ina_clare	ina_clare
jarl_kulle	jarl_kulle
jack_kao	jack_kao
norm_grabowski	norm_grabowski
nicholas_selby	nicholas_selby
ulf_brunnberg	ulf_brunnberg
terence_longdon	terence_longdon
richard_lund	richard_lund
amanda_ooms	amanda_ooms
raghu_babu	raghu_babu
angus_mackay_(actor)	angus_mackay_(actor)
marilyn_jess	marilyn_jess
penelope_dudley-ward	penelope_dudley-ward
david_gwillim	david_gwillim
brian_surewood	brian_surewood
mado_maurin	mado_maurin
anna_nakagawa	anna_nakagawa
torgny_anderberg	torgny_anderberg
betty_lawford	betty_lawford
donnelly_rhodes	donnelly_rhodes
marie_ault	marie_ault
reginald_long	reginald_long
don_li	don_li
zheng_geping	zheng_geping
janice_man	janice_man
sandra_ng	sandra_ng
georg_adelly	georg_adelly
merle_tottenham	merle_tottenham
jiang_qinqin	jiang_qinqin
michiyo_kogure	michiyo_kogure
bernard_musson	bernard_musson
liu_xiaoqing	liu_xiaoqing
saya_misaki	saya_misaki
patricia_plunkett	patricia_plunkett
niki_chow	niki_chow
pierre_boulanger	pierre_boulanger
lau_kar-leung	lau_kar-leung
roy_emerton	roy_emerton
toni_ribas	toni_ribas
mark_daly_(actor)	mark_daly_(actor)
maurice_garrel	maurice_garrel
eric_christmas	eric_christmas
paul_frankeur	paul_frankeur
sammo_hung	sammo_hung
harry_locke	harry_locke
shawn_yue	shawn_yue
zhang_ruifang	zhang_ruifang
hugh_burden	hugh_burden
carl_billquist	carl_billquist
wylie_watson	wylie_watson
eri_ishida	eri_ishida
hao_lei	hao_lei
henry_thia	henry_thia
mary_millington	mary_millington
rio_matsumoto	rio_matsumoto
clive_morton	clive_morton
yoyo_chen	yoyo_chen
joseph_chang	joseph_chang
alex_jordan	alex_jordan
ashlyn_gere	ashlyn_gere
rebecca_lord	rebecca_lord
harry_s._morgan	harry_s._morgan
olivier_marchal	olivier_marchal
candy_lo	candy_lo
renji_ishibashi	renji_ishibashi
miki_sakai	miki_sakai
carina_lau	carina_lau
takeo_chii	takeo_chii
folke_sundquist	folke_sundquist
teresa_cheung_(actress)	teresa_cheung_(actress)
chiara_mastroianni	chiara_mastroianni
david_chiang	david_chiang
alektra_blue	alektra_blue
shingo_yamashiro	shingo_yamashiro
aurora_snow	aurora_snow
judy_kelly	judy_kelly
paul_faivre	paul_faivre
ryoko_kobayashi	ryoko_kobayashi
katsunosuke_hori	katsunosuke_hori
edna_best	edna_best
barry_mackay_(actor)	barry_mackay_(actor)
nobuko_otowa	nobuko_otowa
angela_tong	angela_tong
jenna_jameson	jenna_jameson
eva_angelina	eva_angelina
fu_biao	fu_biao
nozomu_sasaki	nozomu_sasaki
walter_fitzgerald	walter_fitzgerald
john_botvid	john_botvid
danny_mountain	danny_mountain
soh_hang-suen	soh_hang-suen
shin_saburi	shin_saburi
bambi_woods	bambi_woods
eric_tsang	eric_tsang
fritiof_billquist	fritiof_billquist
catrin_westerlund	catrin_westerlund
tollie_zellman	tollie_zellman
lesley_brook	lesley_brook
tom_chatto	tom_chatto
lena_nyman	lena_nyman
louisa_moritz	louisa_moritz
heron_carvic	heron_carvic
arpad_miklos	arpad_miklos
shinobu_otake	shinobu_otake
joyce_tang	joyce_tang
tova_magnusson	tova_magnusson
takeshi_watabe	takeshi_watabe
hisaya_morishige	hisaya_morishige
marcelle_praince	marcelle_praince
louise_hampton	louise_hampton
thomas_henty	thomas_henty
savanna_samson	savanna_samson
jackie_chan	jackie_chan
takatoshi_kaneko	takatoshi_kaneko
tomoyuki_dan	tomoyuki_dan
clare-hope_ashitey	clare-hope_ashitey
darry_cowl	darry_cowl
carmella_bing	carmella_bing
