golf_in_the_kingdom	golf_in_the_kingdom
my_shit_life_so_far	my_shit_life_so_far
the_truth_about_poop	the_truth_about_poop
oh,_the_places_you'll_go!	oh,_the_places_you'll_go!
the_story_of_tracy_beaker	the_story_of_tracy_beaker
the_false_inspector_dew	the_false_inspector_dew
prince_caspian	prince_caspian
the_tiny_kite_of_eddie_wing	the_tiny_kite_of_eddie_wing
wielding_a_red_sword	wielding_a_red_sword
women_of_the_apocalypse	women_of_the_apocalypse
the_scorpio_illusion	the_scorpio_illusion
feast_of_souls	feast_of_souls
the_cat_in_the_hat	the_cat_in_the_hat
old_ghosts_of_new_england	old_ghosts_of_new_england
tell_the_wolves_i'm_home	tell_the_wolves_i'm_home
moon_over_manifest	moon_over_manifest
child_of_the_prophecy	child_of_the_prophecy
the_dark_griffin	the_dark_griffin
fire_in_the_mist	fire_in_the_mist
stonemouth	stonemouth
jaz_parks_series	jaz_parks_series
how_to_be_cool	how_to_be_cool
one_morning_like_a_bird	one_morning_like_a_bird
library_lion	library_lion
the_doll_people	the_doll_people
too_fat_to_fish	too_fat_to_fish
marked_by_fire	marked_by_fire
river_secrets	river_secrets
consider_the_lobster	consider_the_lobster
this_book_is_broken	this_book_is_broken
blaze_of_silver	blaze_of_silver
power_hungry	power_hungry
the_final_key	the_final_key
white_lies_(for_my_mother)	white_lies_(for_my_mother)
the_bottom_billion	the_bottom_billion
the_panic_zone	the_panic_zone
stuck_in_neutral	stuck_in_neutral
princess_of_gossip	princess_of_gossip
how_the_grinch_stole_christmas!	how_the_grinch_stole_christmas!
city_of_bohane	city_of_bohane
the_ghost_map	the_ghost_map
love_letters_of_great_men	love_letters_of_great_men
internet_dates_from_hell	internet_dates_from_hell
the_500_hats_of_bartholomew_cubbins	the_500_hats_of_bartholomew_cubbins
death_is_now_my_neighbour	death_is_now_my_neighbour
bossypants	bossypants
we_still_hold_these_truths	we_still_hold_these_truths
the_language_of_goldfish	the_language_of_goldfish
isaiah_eleven	isaiah_eleven
joined-up_thinking	joined-up_thinking
here_my_home_once_stood	here_my_home_once_stood
the_overton_window	the_overton_window
the_last_voyage_of_columbus	the_last_voyage_of_columbus
just_in_case	just_in_case
the_riddle_of_the_third_mile	the_riddle_of_the_third_mile
i_drink_for_a_reason	i_drink_for_a_reason
the_checklist_manifesto	the_checklist_manifesto
the_last_castaways	the_last_castaways
the_lamplighter	the_lamplighter
blown_for_good	blown_for_good
the_tenth_circle	the_tenth_circle
in_the_woods	in_the_woods
common_sense_on_mutual_funds	common_sense_on_mutual_funds
the_enormous_crocodile	the_enormous_crocodile
the_seven_storey_mountain	the_seven_storey_mountain
the_qi_book_of_the_dead	the_qi_book_of_the_dead
kubrick_the_dog	kubrick_the_dog
wibbly_pig's_silly_big_bear	wibbly_pig's_silly_big_bear
on_truth	on_truth
the_longest_ride	the_longest_ride
what_a_week_to_risk_it_all	what_a_week_to_risk_it_all
fig_pudding	fig_pudding
lust_for_justice	lust_for_justice
irish_stew!	irish_stew!
the_very_bad_book	the_very_bad_book
the_accident_man	the_accident_man
pawana	pawana
the_sell-in	the_sell-in
the_aware	the_aware
sinners_in_the_hands_of_an_angry_god	sinners_in_the_hands_of_an_angry_god
the_demigod_diaries	the_demigod_diaries
for_one_more_day	for_one_more_day
the_witches_of_worm	the_witches_of_worm
the_conscience_of_a_liberal	the_conscience_of_a_liberal
killing_lincoln	killing_lincoln
the_psychology_of_the_simpsons	the_psychology_of_the_simpsons
lord_of_souls	lord_of_souls
a_mango-shaped_space	a_mango-shaped_space
trading_secrets	trading_secrets
i_was_a_rat!_or_the_scarlet_slippers	i_was_a_rat!_or_the_scarlet_slippers
the_law_of_dreams	the_law_of_dreams
the_burning_bridge	the_burning_bridge
time_to_say_hello	time_to_say_hello
the_fire-eaters	the_fire-eaters
the_lost_art_of_gratitude	the_lost_art_of_gratitude
friends,_lovers,_chocolate	friends,_lovers,_chocolate
biscuit_bear	biscuit_bear
girl_imagined_by_chance	girl_imagined_by_chance
looking_for_x	looking_for_x
the_hallo-wiener	the_hallo-wiener
the_truth_about_muhammad	the_truth_about_muhammad
the_fox_effect	the_fox_effect
the_fortune_at_the_bottom_of_the_pyramid	the_fortune_at_the_bottom_of_the_pyramid
the_dervish_house	the_dervish_house
the_yellow_birds	the_yellow_birds
the_gruffalo	the_gruffalo
the_riven_kingdom	the_riven_kingdom
the_time_in_between	the_time_in_between
into_a_dark_realm	into_a_dark_realm
murder_house	murder_house
despite_the_falling_snow	despite_the_falling_snow
white_mughals	white_mughals
little_mouse's_big_book_of_fears	little_mouse's_big_book_of_fears
sammy_&_sue_go_green_too!	sammy_&_sue_go_green_too!
the_still_point	the_still_point
a_sound_like_someone_trying_not_to_make_a_sound	a_sound_like_someone_trying_not_to_make_a_sound
austenland	austenland
miles_to_go	miles_to_go
a_little_piece_of_ground	a_little_piece_of_ground
the_lost_stories	the_lost_stories
the_meaning_of_liff	the_meaning_of_liff
the_black_book_of_communism	the_black_book_of_communism
an_april_shroud	an_april_shroud
the_adventures_of_unemployed_man	the_adventures_of_unemployed_man
a_supposedly_fun_thing_i'll_never_do_again	a_supposedly_fun_thing_i'll_never_do_again
should_have_got_off_at_sydney_parade	should_have_got_off_at_sydney_parade
no_time_for_goodbye	no_time_for_goodbye
return_to_groosham_grange	return_to_groosham_grange
a_tragic_legacy	a_tragic_legacy
marvin_k._mooney_will_you_please_go_now!	marvin_k._mooney_will_you_please_go_now!
the_magical_worlds_of_harry_potter	the_magical_worlds_of_harry_potter
magic's_child	magic's_child
raising_steam	raising_steam
merchanter's_luck	merchanter's_luck
the_maytrees	the_maytrees
caine_black_knife	caine_black_knife
the_millionaire's_wife	the_millionaire's_wife
five_on_a_treasure_island	five_on_a_treasure_island
the_secret_life_of_damian_spinelli	the_secret_life_of_damian_spinelli
late_nights_on_air	late_nights_on_air
the_evolution_of_god	the_evolution_of_god
how_to_eat_a_small_country	how_to_eat_a_small_country
the_remorseful_day	the_remorseful_day
the_sign_of_the_crooked_arrow	the_sign_of_the_crooked_arrow
words_of_radiance	words_of_radiance
hooray_for_diffendoofer_day!	hooray_for_diffendoofer_day!
the_crossing_of_ingo	the_crossing_of_ingo
return_to_mars	return_to_mars
that_pesky_rat	that_pesky_rat
inspector_ghote's_first_case	inspector_ghote's_first_case
dunc's_halloween	dunc's_halloween
kate_remembered	kate_remembered
de_puinhopen_van_acht_jaar_paars	de_puinhopen_van_acht_jaar_paars
such_a_pretty_girl	such_a_pretty_girl
billionaire_boy	billionaire_boy
one_model_nation	one_model_nation
on_snow	on_snow
snakes_in_suits	snakes_in_suits
banewreaker	banewreaker
busting_vegas	busting_vegas
fast_food_nation	fast_food_nation
death_troopers	death_troopers
here_come_the_blobbies	here_come_the_blobbies
the_bane_chronicles	the_bane_chronicles
what_a_week_omnibus_books_4-6	what_a_week_omnibus_books_4-6
the_ponder_heart	the_ponder_heart
the_king's_buccaneer	the_king's_buccaneer
the_turbulent_term_of_tyke_tiler	the_turbulent_term_of_tyke_tiler
kosher_jesus	kosher_jesus
head_in_flames	head_in_flames
the_gum_thief	the_gum_thief
imzadi	imzadi
the_devil's_breath	the_devil's_breath
the_disunited_states_of_america	the_disunited_states_of_america
dream_stuff	dream_stuff
nothing_like_a_dame	nothing_like_a_dame
the_black_tattoo	the_black_tattoo
skywriting_by_word_of_mouth	skywriting_by_word_of_mouth
anya's_ghost	anya's_ghost
my_holocaust	my_holocaust
in_defense_of_food	in_defense_of_food
mistress_of_the_empire	mistress_of_the_empire
one_month_to_live	one_month_to_live
head_smash	head_smash
black_sun_rising	black_sun_rising
a_buffalope's_tale	a_buffalope's_tale
pirate_diary	pirate_diary
shadow_forest	shadow_forest
the_empty_city	the_empty_city
the_myst_reader	the_myst_reader
chicks_with_guns	chicks_with_guns
dunc_gets_tweaked	dunc_gets_tweaked
finding_violet_park	finding_violet_park
the_tide_knot	the_tide_knot
nothing_to_envy	nothing_to_envy
winner-take-all_politics	winner-take-all_politics
how_i_live_now	how_i_live_now
the_unforgiving_wind	the_unforgiving_wind
the_holcroft_covenant	the_holcroft_covenant
counting_the_eons	counting_the_eons
forest_born	forest_born
nietzsche's_kisses	nietzsche's_kisses
goodnight_moon	goodnight_moon
general_winston's_daughter	general_winston's_daughter
demon_apocalypse	demon_apocalypse
the_peaceful_pill_handbook	the_peaceful_pill_handbook
the_blt_cookbook	the_blt_cookbook
the_aquitaine_progression	the_aquitaine_progression
my_big_brother,_boris	my_big_brother,_boris
the_code_of_romulus	the_code_of_romulus
a_gentleman's_guide_to_graceful_living	a_gentleman's_guide_to_graceful_living
dunc's_doll	dunc's_doll
a_spaniard_in_the_works	a_spaniard_in_the_works
lilies_in_december	lilies_in_december
two_caravans	two_caravans
requiem_for_a_fish	requiem_for_a_fish
a_matter_of_profit	a_matter_of_profit
the_road_of_bones	the_road_of_bones
transcension	transcension
feather_boy	feather_boy
stellaluna	stellaluna
without_feathers	without_feathers
the_meanest_doll_in_the_world	the_meanest_doll_in_the_world
bleeding_shadows	bleeding_shadows
every_you,_every_me	every_you,_every_me
animal,_vegetable,_miracle	animal,_vegetable,_miracle
the_feather_men	the_feather_men
leonardo's_swans	leonardo's_swans
the_wimpy_kid_movie_diary	the_wimpy_kid_movie_diary
son_of_the_shadows	son_of_the_shadows
three_strong_women	three_strong_women
the_diana_chronicles	the_diana_chronicles
buddha_da	buddha_da
citizen_cyborg	citizen_cyborg
the_knife_that_killed_me	the_knife_that_killed_me
women_en_large	women_en_large
the_deniers	the_deniers
the_flying_trunk	the_flying_trunk
the_ruins_of_gorlan	the_ruins_of_gorlan
wolf_of_the_plains	wolf_of_the_plains
the_final_showdown	the_final_showdown
bush_at_war	bush_at_war
the_wiki_way	the_wiki_way
the_areas_of_my_expertise	the_areas_of_my_expertise
the_sweetest_fig	the_sweetest_fig
the_beatrice_letters	the_beatrice_letters
breaking_stalin's_nose	breaking_stalin's_nose
the_case_of_the_dirty_bird	the_case_of_the_dirty_bird
the_great_enigma	the_great_enigma
the_third_choice	the_third_choice
zen_ties	zen_ties
death_by_china	death_by_china
your_best_life_now	your_best_life_now
gusher_of_lies	gusher_of_lies
the_beginning_of_infinity	the_beginning_of_infinity
simple_genius	simple_genius
on_a_pale_horse	on_a_pale_horse
erak's_ransom	erak's_ransom
deploying_renewables_2011	deploying_renewables_2011
what_i_was	what_i_was
one_way_forward	one_way_forward
how_to_design_programs	how_to_design_programs
a_real_basket_case	a_real_basket_case
the_last_stand_of_the_tin_can_sailors	the_last_stand_of_the_tin_can_sailors
what_a_week_to_get_real	what_a_week_to_get_real
shutter_island	shutter_island
the_melting_of_maggie_bean	the_melting_of_maggie_bean
royal_exile	royal_exile
aramaya	aramaya
the_barn_burner	the_barn_burner
dear_nobody	dear_nobody
the_party_of_death	the_party_of_death
xiagu_danxin	xiagu_danxin
the_tragedy_of_arthur	the_tragedy_of_arthur
irish_tiger	irish_tiger
the_childhood_of_jesus	the_childhood_of_jesus
a_spot_of_bother	a_spot_of_bother
the_way_through_the_woods	the_way_through_the_woods
machine_of_death	machine_of_death
oxford_encyclopedia_of_maritime_history	oxford_encyclopedia_of_maritime_history
the_boy_in_the_dress	the_boy_in_the_dress
the_discworld_mapp	the_discworld_mapp
massacre_at_mountain_meadows	massacre_at_mountain_meadows
every_inch_a_king	every_inch_a_king
lords_of_the_bow	lords_of_the_bow
the_sigma_protocol	the_sigma_protocol
birds_britannica	birds_britannica
the_kings_of_clonmel	the_kings_of_clonmel
the_jewel_that_was_ours	the_jewel_that_was_ours
praisesong_for_the_widow	praisesong_for_the_widow
our_last_best_chance	our_last_best_chance
the_charm_school	the_charm_school
citizen's_briefing_book	citizen's_briefing_book
so_this_is_how_it_ends	so_this_is_how_it_ends
the_rozabal_line	the_rozabal_line
living_shadows	living_shadows
the_thief_queen's_daughter	the_thief_queen's_daughter
gone_to_the_dogs	gone_to_the_dogs
the_republican_noise_machine	the_republican_noise_machine
the_demigod_files	the_demigod_files
my_many_colored_days	my_many_colored_days
calendar_of_regrets	calendar_of_regrets
a_small_death_in_lisbon	a_small_death_in_lisbon
dunc_breaks_the_record	dunc_breaks_the_record
daisy-head_mayzie	daisy-head_mayzie
the_dark_imbalance	the_dark_imbalance
just_kids	just_kids
the_art_of_the_metaobject_protocol	the_art_of_the_metaobject_protocol
born_confused	born_confused
the_brave_bulls	the_brave_bulls
the_selection	the_selection
the_english_roses	the_english_roses
divided_city	divided_city
in_the_heart_of_the_sea	in_the_heart_of_the_sea
the_prosecution_of_george_w._bush_for_murder	the_prosecution_of_george_w._bush_for_murder
late_show_fun_facts	late_show_fun_facts
two_frogs	two_frogs
bella_at_midnight	bella_at_midnight
the_assassin's_song	the_assassin's_song
the_tyranny_of_experts	the_tyranny_of_experts
tunnels_of_blood	tunnels_of_blood
the_ocean_at_the_end_of_the_lane	the_ocean_at_the_end_of_the_lane
the_winter_knights	the_winter_knights
the_littlest_hitler	the_littlest_hitler
the_secret_order_of_the_gumm_street_girls	the_secret_order_of_the_gumm_street_girls
wings_of_wrath	wings_of_wrath
hotel_world	hotel_world
the_far_reaches	the_far_reaches
servant_of_the_empire	servant_of_the_empire
courting_justice	courting_justice
the_great_stagnation	the_great_stagnation
heavier_than_heaven	heavier_than_heaven
how_we_decide	how_we_decide
scouting_for_boys	scouting_for_boys
maigret_has_scruples	maigret_has_scruples
a_fortress_of_grey_ice	a_fortress_of_grey_ice
tadpole's_promise	tadpole's_promise
how_angel_peterson_got_his_name	how_angel_peterson_got_his_name
goggle-eyes	goggle-eyes
clash_of_eagles	clash_of_eagles
british_bangladeshi_power_&_inspiration_100	british_bangladeshi_power_&_inspiration_100
a_long_long_way	a_long_long_way
after_this	after_this
final_exit	final_exit
wards_of_faerie	wards_of_faerie
the_cruelest_month	the_cruelest_month
the_two_pearls_of_wisdom	the_two_pearls_of_wisdom
the_showgirl_princess	the_showgirl_princess
a_sick_day_for_amos_mcgee	a_sick_day_for_amos_mcgee
that_rabbit_belongs_to_emily_brown	that_rabbit_belongs_to_emily_brown
true_compass	true_compass
la_ronde_et_autres_faits_divers	la_ronde_et_autres_faits_divers
the_scorch_trials	the_scorch_trials
muslim_power_100	muslim_power_100
bloodfire_quest	bloodfire_quest
too_close_to_home	too_close_to_home
do_not_open	do_not_open
the_theory_of_moral_sentiments	the_theory_of_moral_sentiments
the_siege_of_macindaw	the_siege_of_macindaw
dans_l'enfer_des_tournantes	dans_l'enfer_des_tournantes
big_pumpkin	big_pumpkin
splat_the_cat	splat_the_cat
flour_babies	flour_babies
the_dancing_tiger	the_dancing_tiger
the_bridge_at_no_gun_ri	the_bridge_at_no_gun_ri
this_is_herman_cain!	this_is_herman_cain!
speaking_of_jane_roberts	speaking_of_jane_roberts
flash_boys	flash_boys
white_dog_fell_from_the_sky	white_dog_fell_from_the_sky
spilled_water	spilled_water
the_third_god	the_third_god
killing_kennedy	killing_kennedy
born_fighting	born_fighting
tom's_midnight_garden	tom's_midnight_garden
sharing_a_robin's_life	sharing_a_robin's_life
the_god_beneath_the_sea	the_god_beneath_the_sea
king_of_the_pygmies	king_of_the_pygmies
the_real_global_warming_disaster	the_real_global_warming_disaster
the_fall_of_arthur	the_fall_of_arthur
my_crazy_beautiful_life	my_crazy_beautiful_life
more_information_than_you_require	more_information_than_you_require
the_fabled_fourth_graders_of_aesop_elementary_school	the_fabled_fourth_graders_of_aesop_elementary_school
the_politics_of_anti-semitism	the_politics_of_anti-semitism
britain's_everyday_heroes	britain's_everyday_heroes
the_caliph's_house	the_caliph's_house
a_colossal_failure_of_common_sense	a_colossal_failure_of_common_sense
a_rather_english_marriage	a_rather_english_marriage
the_red_necklace	the_red_necklace
when_a_monster_is_born	when_a_monster_is_born
white_house_diary	white_house_diary
slake's_limbo	slake's_limbo
unexplained_fevers	unexplained_fevers
the_great_perhaps	the_great_perhaps
math_girls	math_girls
letters_to_kurt	letters_to_kurt
a_killing_kindness	a_killing_kindness
that_deadman_dance	that_deadman_dance
the_500_most_influential_muslims	the_500_most_influential_muslims
jazzy_in_the_jungle	jazzy_in_the_jungle
the_time_traveler's_almanac	the_time_traveler's_almanac
you_can_heal_your_life	you_can_heal_your_life
kiss_the_girls	kiss_the_girls
the_cat's_table	the_cat's_table
death_in_the_clouds	death_in_the_clouds
the_firework-maker's_daughter	the_firework-maker's_daughter
how_to_be_black	how_to_be_black
tale_of_the_toa	tale_of_the_toa
ente_katha	ente_katha
bones_of_the_hills	bones_of_the_hills
a_catalogue_of_books_printed_in_the_fifteenth_century_now_in_the_bodleian_library	a_catalogue_of_books_printed_in_the_fifteenth_century_now_in_the_bodleian_library
confessions_of_a_video_vixen	confessions_of_a_video_vixen
the_very_hungry_caterpillar	the_very_hungry_caterpillar
look_me_in_the_eye	look_me_in_the_eye
welcome_to_obamaland	welcome_to_obamaland
ice_claw	ice_claw
a_masculine_ending	a_masculine_ending
the_right_attitude_to_rain	the_right_attitude_to_rain
the_sovereign_state	the_sovereign_state
the_charming_quirks_of_others	the_charming_quirks_of_others
alida's_song	alida's_song
daughter_of_the_empire	daughter_of_the_empire
being_a_green_mother	being_a_green_mother
unfamiliar_fishes	unfamiliar_fishes
only_a_theory	only_a_theory
mountain_cat	mountain_cat
evil_genes	evil_genes
den_nya_nordiska_floran	den_nya_nordiska_floran
brief_interviews_with_hideous_men	brief_interviews_with_hideous_men
lady_gaga_x_terry_richardson	lady_gaga_x_terry_richardson
the_one_o'clock_chop	the_one_o'clock_chop
the_mighty_book_of_boosh	the_mighty_book_of_boosh
the_virgin_book_of_british_hit_singles	the_virgin_book_of_british_hit_singles
juliet,_naked	juliet,_naked
the_troll	the_troll
danger_along_the_ohio	danger_along_the_ohio
the_emperor_of_absurdia	the_emperor_of_absurdia
becoming_the_villainess	becoming_the_villainess
monkey_hunting	monkey_hunting
children_playing_before_a_statue_of_hercules	children_playing_before_a_statue_of_hercules
treasure_fever!	treasure_fever!
monica's_story	monica's_story
seduced_by_bacon	seduced_by_bacon
help_at_any_cost	help_at_any_cost
strange_messenger	strange_messenger
oakleaf_bearers	oakleaf_bearers
live_by_night	live_by_night
the_prometheus_deception	the_prometheus_deception
blueberry_girl	blueberry_girl
twilight_comes_twice	twilight_comes_twice
full_metal_jacket_diary	full_metal_jacket_diary
the_wages_of_destruction	the_wages_of_destruction
faerie_tale	faerie_tale
i_kissed_dating_goodbye	i_kissed_dating_goodbye
the_wench_is_dead	the_wench_is_dead
the_intergalactic_kitchen	the_intergalactic_kitchen
no_time_like_show_time	no_time_like_show_time
the_kill_order	the_kill_order
this_is_how_you_lose_her	this_is_how_you_lose_her
more_than_honor	more_than_honor
crossing_the_river	crossing_the_river
the_atlantis_prophecy	the_atlantis_prophecy
assassin's_apprentice	assassin's_apprentice
my_big_fat_supernatural_honeymoon	my_big_fat_supernatural_honeymoon
just_give_me_a_cool_drink_of_water_'fore_i_diiie	just_give_me_a_cool_drink_of_water_'fore_i_diiie
sex_at_dawn	sex_at_dawn
the_zen_of_css_design	the_zen_of_css_design
pizza_kittens	pizza_kittens
fergus_crane	fergus_crane
the_secret_art_of_dr._seuss	the_secret_art_of_dr._seuss
the_encyclopedia_of_fantasy	the_encyclopedia_of_fantasy
the_changeover	the_changeover
a_salty_piece_of_land	a_salty_piece_of_land
morgan's_run	morgan's_run
ladybug_girl	ladybug_girl
the_sharper_your_knife,_the_less_you_cry	the_sharper_your_knife,_the_less_you_cry
the_fleet_street_murders	the_fleet_street_murders
a_solitary_grief	a_solitary_grief
i'm_off	i'm_off
the_crooked_letter	the_crooked_letter
dermaphoria	dermaphoria
the_cat_who_had_60_whiskers	the_cat_who_had_60_whiskers
once_upon_a_secret	once_upon_a_secret
diary_of_a_wimpy_kid	diary_of_a_wimpy_kid
the_giving_tree	the_giving_tree
it's_even_worse_than_it_looks	it's_even_worse_than_it_looks
always_outnumbered,_always_outgunned	always_outnumbered,_always_outgunned
the_winter_of_frankie_machine	the_winter_of_frankie_machine
the_voyage_of_the_dawn_treader	the_voyage_of_the_dawn_treader
the_singing	the_singing
they_call_me_baba_booey	they_call_me_baba_booey
the_autograph_man	the_autograph_man
mars_life	mars_life
the_other_hand	the_other_hand
a_ball_for_daisy	a_ball_for_daisy
hello,_harvest_moon	hello,_harvest_moon
downturn_abbey	downturn_abbey
characters_of_shakespear's_plays	characters_of_shakespear's_plays
a_catskill_eagle	a_catskill_eagle
the_jane_austen_book_club	the_jane_austen_book_club
perfectly_reasonable_deviations_from_the_beaten_track	perfectly_reasonable_deviations_from_the_beaten_track
a_conspiracy_of_friends	a_conspiracy_of_friends
the_royal_ranger	the_royal_ranger
understanding_consciousness	understanding_consciousness
it's_bigger_than_hip_hop	it's_bigger_than_hip_hop
pencil_of_doom!	pencil_of_doom!
targeted_killing_in_international_law	targeted_killing_in_international_law
ritournelle_de_la_faim	ritournelle_de_la_faim
an_excellent_mystery	an_excellent_mystery
children_of_the_thunder	children_of_the_thunder
only_death_is_real	only_death_is_real
deadly_cults	deadly_cults
the_innocent_mage	the_innocent_mage
the_second_book_of_general_ignorance	the_second_book_of_general_ignorance
the_gruffalo's_child	the_gruffalo's_child
the_sheep-pig	the_sheep-pig
what_a_week_omnibus_books_1-3	what_a_week_omnibus_books_1-3
mommie_dearest	mommie_dearest
the_september_society	the_september_society
letter_to_a_christian_nation	letter_to_a_christian_nation
the_book_of_animal_ignorance	the_book_of_animal_ignorance
godslayer	godslayer
the_zookeeper's_wife	the_zookeeper's_wife
the_book_of_general_ignorance	the_book_of_general_ignorance
american_grown	american_grown
100_best_australian_albums	100_best_australian_albums
living_with_crazy_buttocks	living_with_crazy_buttocks
the_oversoul_seven_trilogy	the_oversoul_seven_trilogy
both_sides_of_time	both_sides_of_time
my_booky_wook	my_booky_wook
nellie,_1983	nellie,_1983
deadly_little_secrets	deadly_little_secrets
refugee_boy	refugee_boy
