deep_blue_sea_(1999_film)	deep_blue_sea_(1999_film)
fury_in_the_pacific	fury_in_the_pacific
house_on_fire	house_on_fire
blackboards	blackboards
the_love_machine_(film)	the_love_machine_(film)
city_of_joy_(film)	city_of_joy_(film)
cocaine_wars	cocaine_wars
fletch_lives	fletch_lives
cool_as_ice	cool_as_ice
the_big_bounce_(2004_film)	the_big_bounce_(2004_film)
the_miracle_of_morgan's_creek	the_miracle_of_morgan's_creek
hustle_(1975_film)	hustle_(1975_film)
across_110th_street	across_110th_street
welcome_to_sajjanpur	welcome_to_sajjanpur
take_my_eyes	take_my_eyes
the_legend_of_the_roller_blade_seven	the_legend_of_the_roller_blade_seven
do_anjaane	do_anjaane
serpent_of_the_nile	serpent_of_the_nile
sachein	sachein
tere_naam	tere_naam
la_chienne	la_chienne
my_father_the_hero_(1994_film)	my_father_the_hero_(1994_film)
s._darko	s._darko
mondo_topless	mondo_topless
bad_influence_(film)	bad_influence_(film)
in_orange	in_orange
bellezze_in_bicicletta	bellezze_in_bicicletta
beyond_the_mat	beyond_the_mat
lost_in_the_desert	lost_in_the_desert
lolita's_club	lolita's_club
ek_chalis_ki_last_local	ek_chalis_ki_last_local
bhoot_bungla	bhoot_bungla
von_ryan's_express	von_ryan's_express
desh_premee	desh_premee
jaagruti	jaagruti
star_spangled_rhythm	star_spangled_rhythm
reluctant_bride	reluctant_bride
cujo_(film)	cujo_(film)
strictly_business_(1991_film)	strictly_business_(1991_film)
love,_mary	love,_mary
soldier_in_the_rain	soldier_in_the_rain
au_pair_(film)	au_pair_(film)
meendum_kokila	meendum_kokila
marupadiyum	marupadiyum
greenfingers	greenfingers
kikoku	kikoku
bloody_mama	bloody_mama
parrish_(film)	parrish_(film)
black_zoo	black_zoo
the_price_of_power	the_price_of_power
mr._majestyk	mr._majestyk
because_you're_mine	because_you're_mine
thotti_jaya	thotti_jaya
the_guardsman	the_guardsman
pilates_for_indie_rockers	pilates_for_indie_rockers
dollars_trilogy	dollars_trilogy
the_blue_max	the_blue_max
chopper_(film)	chopper_(film)
ajantrik	ajantrik
the_blonds	the_blonds
nandha	nandha
saat_rang_ke_sapne	saat_rang_ke_sapne
coney_island_(1943_film)	coney_island_(1943_film)
chandni	chandni
the_angel_wore_red	the_angel_wore_red
aparajito	aparajito
adavi_ramudu_(1977_film)	adavi_ramudu_(1977_film)
lady_in_the_water	lady_in_the_water
io_la_conoscevo_bene	io_la_conoscevo_bene
desamuduru	desamuduru
the_first_wives_club	the_first_wives_club
big_trouble_in_little_china	big_trouble_in_little_china
easy_living_(1937_film)	easy_living_(1937_film)
the_man_in_the_moon	the_man_in_the_moon
thirteen_conversations_about_one_thing	thirteen_conversations_about_one_thing
a_thief_in_paradise	a_thief_in_paradise
ring_of_spies	ring_of_spies
the_iron_crown	the_iron_crown
la_terra_trema	la_terra_trema
ghajini_(2005_film)	ghajini_(2005_film)
ultraman_story	ultraman_story
madame_sousatzka	madame_sousatzka
khudgarz	khudgarz
mr._3000	mr._3000
run_lola_run	run_lola_run
the_skeleton_key	the_skeleton_key
the_hobbit_(film_series)	the_hobbit_(film_series)
the_good_mother_(1988_film)	the_good_mother_(1988_film)
another_nice_mess	another_nice_mess
bad_taste	bad_taste
sonnal_thaan_kaadhala	sonnal_thaan_kaadhala
a_woman's_face	a_woman's_face
manakanakku	manakanakku
shake,_rattle_&_roll_x	shake,_rattle_&_roll_x
le_boucher	le_boucher
dracula_(1979_film)	dracula_(1979_film)
the_razor's_edge_(1984_film)	the_razor's_edge_(1984_film)
the_games_(film)	the_games_(film)
eagle_vs_shark	eagle_vs_shark
wild_boys_of_the_road	wild_boys_of_the_road
thirumalai	thirumalai
the_perfect_weapon	the_perfect_weapon
the_last_legion	the_last_legion
the_scorpion_king	the_scorpion_king
armaan_(2003_film)	armaan_(2003_film)
the_sea_shall_not_have_them	the_sea_shall_not_have_them
the_devil-ship_pirates	the_devil-ship_pirates
three_the_hard_way_(film)	three_the_hard_way_(film)
the_animal	the_animal
the_knack_...and_how_to_get_it	the_knack_...and_how_to_get_it
jesus'_son	jesus'_son
read_my_lips_(film)	read_my_lips_(film)
the_bride_of_glomdal	the_bride_of_glomdal
the_importance_of_being_earnest_(1952_film)	the_importance_of_being_earnest_(1952_film)
profesor_wilczur	profesor_wilczur
gayab	gayab
call_of_the_flesh	call_of_the_flesh
krishna_(1996_film)	krishna_(1996_film)
kshatriya_(film)	kshatriya_(film)
you're_a_sweetheart	you're_a_sweetheart
en_uyir_thozhan	en_uyir_thozhan
awaargi	awaargi
lovers_of_the_arctic_circle	lovers_of_the_arctic_circle
chicken_rice_war	chicken_rice_war
chingaari	chingaari
pyaasa	pyaasa
hanging_up	hanging_up
vinayaka_chaviti	vinayaka_chaviti
some_kind_of_hero	some_kind_of_hero
father_brown_(film)	father_brown_(film)
seemabaddha	seemabaddha
dick_tracy_vs._crime,_inc.	dick_tracy_vs._crime,_inc.
episode_(film)	episode_(film)
have_dreams,_will_travel	have_dreams,_will_travel
oye_lucky!_lucky_oye!	oye_lucky!_lucky_oye!
the_shopaholics	the_shopaholics
bienvenue_chez_les_ch'tis	bienvenue_chez_les_ch'tis
alaap	alaap
another_fine_mess	another_fine_mess
the_artist's_dilemma	the_artist's_dilemma
hathyar_(1989_film)	hathyar_(1989_film)
the_world_unseen	the_world_unseen
skywhales	skywhales
vanaprastham	vanaprastham
guest_house_paradiso	guest_house_paradiso
deal_of_the_century	deal_of_the_century
crisis_(1946_film)	crisis_(1946_film)
a_heart_in_winter	a_heart_in_winter
operation_daybreak	operation_daybreak
swapner_din	swapner_din
tragic_hunt	tragic_hunt
the_ballad_of_narayama_(1983_film)	the_ballad_of_narayama_(1983_film)
the_bondage_master	the_bondage_master
savage_dawn	savage_dawn
company_(film)	company_(film)
circus_angel	circus_angel
jamaica_inn_(film)	jamaica_inn_(film)
phenomena_(film)	phenomena_(film)
chiriyakhana	chiriyakhana
citizen_ruth	citizen_ruth
little_nicky	little_nicky
she_(1965_film)	she_(1965_film)
tiovivo_c._1950	tiovivo_c._1950
article_99	article_99
dil_chahta_hai	dil_chahta_hai
cobb_(film)	cobb_(film)
the_marihuana_story	the_marihuana_story
door_ka_raahi	door_ka_raahi
easy_years	easy_years
the_double_0_kid	the_double_0_kid
ardh_satya	ardh_satya
the_secret_of_roan_inish	the_secret_of_roan_inish
photographing_fairies	photographing_fairies
american_outlaws	american_outlaws
il_camorrista	il_camorrista
muchachas_que_estudian	muchachas_que_estudian
bad_boys_ii	bad_boys_ii
savaal	savaal
smiles_of_a_summer_night	smiles_of_a_summer_night
good_boy!	good_boy!
mast_(film)	mast_(film)
st._elmo's_fire_(film)	st._elmo's_fire_(film)
parents_(film)	parents_(film)
raajjiyam	raajjiyam
the_organizer	the_organizer
the_awakening_(1980_film)	the_awakening_(1980_film)
go_(1999_film)	go_(1999_film)
top_banana_(film)	top_banana_(film)
the_anderson_platoon	the_anderson_platoon
germany,_year_zero	germany,_year_zero
spirits_of_the_dead	spirits_of_the_dead
white_witch_doctor_(film)	white_witch_doctor_(film)
escape_from_new_york	escape_from_new_york
happy_gilmore	happy_gilmore
naan_potta_savaal	naan_potta_savaal
the_fighting_69th	the_fighting_69th
challenge_(1984_film)	challenge_(1984_film)
the_crazy_ray	the_crazy_ray
the_fan_(1996_film)	the_fan_(1996_film)
the_incredible_shrinking_woman	the_incredible_shrinking_woman
f_for_fake	f_for_fake
buster_keaton_rides_again	buster_keaton_rides_again
sybil_(2007_film)	sybil_(2007_film)
welcome_to_woop_woop	welcome_to_woop_woop
the_cold_room	the_cold_room
the_comfort_of_strangers_(film)	the_comfort_of_strangers_(film)
kandukondain_kandukondain	kandukondain_kandukondain
an_evening_in_paris	an_evening_in_paris
the_time_traveler's_wife_(film)	the_time_traveler's_wife_(film)
love_love_love_(1989_film)	love_love_love_(1989_film)
ram_lakhan	ram_lakhan
monsieur_klein	monsieur_klein
the_curse_of_frankenstein	the_curse_of_frankenstein
don_olsen_kommer_til_byen	don_olsen_kommer_til_byen
malice_(film)	malice_(film)
the_little_vampire_(film)	the_little_vampire_(film)
jo_(film)	jo_(film)
moggina_manasu	moggina_manasu
the_iron_giant	the_iron_giant
this_sporting_life	this_sporting_life
raktamukhi_neela	raktamukhi_neela
the_hoax	the_hoax
used_people	used_people
the_man_who_changed_his_mind	the_man_who_changed_his_mind
the_claim	the_claim
jab_pyar_kisi_se_hota_hai	jab_pyar_kisi_se_hota_hai
piccolo_mondo_antico	piccolo_mondo_antico
heaven's_soldiers	heaven's_soldiers
the_black_windmill	the_black_windmill
anbe_anbe	anbe_anbe
bellissima_(film)	bellissima_(film)
adventures_in_babysitting	adventures_in_babysitting
gemini_(1999_film)	gemini_(1999_film)
silver_saddle	silver_saddle
story_of_a_young_couple	story_of_a_young_couple
amir_garib	amir_garib
janmadata	janmadata
angora_love	angora_love
public_enemy_returns	public_enemy_returns
johnny_guitar	johnny_guitar
plasticine_crow	plasticine_crow
il_boss	il_boss
badal_paree	badal_paree
somewhere_in_time_(film)	somewhere_in_time_(film)
cosy_dens	cosy_dens
the_third_generation_(1979_film)	the_third_generation_(1979_film)
spaceways	spaceways
troma's_war	troma's_war
the_great_white_hope_(film)	the_great_white_hope_(film)
ilaiyavan	ilaiyavan
the_happy_road	the_happy_road
method_(film)	method_(film)
godavari_(film)	godavari_(film)
the_day_the_fish_came_out	the_day_the_fish_came_out
any_mother's_son	any_mother's_son
blackhawk_(serial)	blackhawk_(serial)
satyameba_jayate	satyameba_jayate
cowards_bend_the_knee	cowards_bend_the_knee
aap_to_aise_na_the	aap_to_aise_na_the
thalaimagan	thalaimagan
missing_(film)	missing_(film)
the_nazi_plan	the_nazi_plan
three_girls_from_rome	three_girls_from_rome
incendiary_blonde	incendiary_blonde
on_our_own_land	on_our_own_land
the_avengers_(1998_film)	the_avengers_(1998_film)
dead_daughters	dead_daughters
aas_paas	aas_paas
blondie_goes_to_college	blondie_goes_to_college
de_besejrede_pebersvende	de_besejrede_pebersvende
the_angry_silence	the_angry_silence
fatal_beauty	fatal_beauty
tough_guys	tough_guys
goin'_south	goin'_south
tumhari_kasam	tumhari_kasam
winner_(film)	winner_(film)
roadside_romeo	roadside_romeo
secrets_of_the_psychics	secrets_of_the_psychics
alias_gardelito	alias_gardelito
hobson's_choice_(1954_film)	hobson's_choice_(1954_film)
rome,_open_city	rome,_open_city
ten_seconds_to_hell	ten_seconds_to_hell
the_apprenticeship_of_duddy_kravitz_(film)	the_apprenticeship_of_duddy_kravitz_(film)
dr._seuss'_how_the_grinch_stole_christmas_(film)	dr._seuss'_how_the_grinch_stole_christmas_(film)
the_fiances	the_fiances
the_tale_of_sweeney_todd	the_tale_of_sweeney_todd
devadasu_(2006_film)	devadasu_(2006_film)
goodbye,_20th_century!	goodbye,_20th_century!
the_big_white	the_big_white
big_daddy_(1999_film)	big_daddy_(1999_film)
the_flight_of_the_phoenix_(1965_film)	the_flight_of_the_phoenix_(1965_film)
slaughter_high	slaughter_high
san_francisco_(1936_film)	san_francisco_(1936_film)
eleven_men_out	eleven_men_out
junior_(1994_film)	junior_(1994_film)
journey_to_the_center_of_the_earth_(1959_film)	journey_to_the_center_of_the_earth_(1959_film)
the_bank_job	the_bank_job
if_all_the_guys_in_the_world	if_all_the_guys_in_the_world
paarthale_paravasam	paarthale_paravasam
the_bliss_of_mrs._blossom	the_bliss_of_mrs._blossom
rettai_vaal_kuruvi	rettai_vaal_kuruvi
jwaar_bhata	jwaar_bhata
ma_femme_s'appelle_maurice	ma_femme_s'appelle_maurice
the_dish	the_dish
rakshak	rakshak
mob_sister	mob_sister
all_the_invisible_children	all_the_invisible_children
el_bonaerense	el_bonaerense
jasmine_women	jasmine_women
the_best_bet	the_best_bet
mr._magorium's_wonder_emporium	mr._magorium's_wonder_emporium
301,_302	301,_302
going_spanish	going_spanish
you're_a_big_boy_now	you're_a_big_boy_now
liar_liar	liar_liar
four_sided_triangle	four_sided_triangle
rosaura_at_10_o'clock	rosaura_at_10_o'clock
kong_island	kong_island
prime_cut	prime_cut
down_among_the_z_men	down_among_the_z_men
the_happiness_of_the_katakuris	the_happiness_of_the_katakuris
no_escape_(1994_film)	no_escape_(1994_film)
bright_lights_(1930_film)	bright_lights_(1930_film)
niagara_motel	niagara_motel
last_orgy_of_the_third_reich	last_orgy_of_the_third_reich
mr._garagasa	mr._garagasa
tell_me_that_you_love_me,_junie_moon	tell_me_that_you_love_me,_junie_moon
dreamer_(2005_film)	dreamer_(2005_film)
the_red_shoes_(1948_film)	the_red_shoes_(1948_film)
the_spell_of_the_circus	the_spell_of_the_circus
story_of_a_prostitute	story_of_a_prostitute
the_ballad_of_andy_crocker	the_ballad_of_andy_crocker
just_follow_law	just_follow_law
le_beau_mariage	le_beau_mariage
so_goes_my_love	so_goes_my_love
all_the_queen's_men	all_the_queen's_men
copycat_(film)	copycat_(film)
rio_rita_(1929_film)	rio_rita_(1929_film)
hari-bhari	hari-bhari
miracle_at_st._anna	miracle_at_st._anna
table_for_five	table_for_five
aaj_ka_andha_kanoon	aaj_ka_andha_kanoon
brotherhood_of_the_wolf	brotherhood_of_the_wolf
major_barbara_(film)	major_barbara_(film)
derby_day_(1952_film)	derby_day_(1952_film)
i_met_my_love_again	i_met_my_love_again
hearts_divided	hearts_divided
nowhere_in_africa	nowhere_in_africa
sahasa_veerudu_sagara_kanya	sahasa_veerudu_sagara_kanya
billy_bathgate_(film)	billy_bathgate_(film)
honeymoon_(1959_film)	honeymoon_(1959_film)
bluffmaster!	bluffmaster!
imaginary_heroes	imaginary_heroes
the_barker	the_barker
righteous_kill	righteous_kill
alluda_majaka	alluda_majaka
hum_aapke_dil_mein_rehte_hain	hum_aapke_dil_mein_rehte_hain
the_human_stain_(film)	the_human_stain_(film)
kapurush	kapurush
house_of_flying_daggers	house_of_flying_daggers
subash_chandra_bose_(film)	subash_chandra_bose_(film)
the_idiot_(1951_film)	the_idiot_(1951_film)
narasimhudu	narasimhudu
for_eyes_only	for_eyes_only
bawarchi	bawarchi
kursi_aur_qanoon	kursi_aur_qanoon
shanghai_knights	shanghai_knights
midnight_mary	midnight_mary
aanivaer	aanivaer
the_years_between_(film)	the_years_between_(film)
campbell's_kingdom	campbell's_kingdom
maanavan	maanavan
domino_(film)	domino_(film)
the_strange_world_of_coffin_joe	the_strange_world_of_coffin_joe
mattoru_seetha	mattoru_seetha
kissing_a_fool	kissing_a_fool
korczak_(film)	korczak_(film)
le_cercle_rouge	le_cercle_rouge
they_just_had_to_get_married	they_just_had_to_get_married
madame_bovary_(1949_film)	madame_bovary_(1949_film)
the_icelandic_dream	the_icelandic_dream
beyond_the_last_mountain	beyond_the_last_mountain
mousehunt_(film)	mousehunt_(film)
lawyer_lawyer	lawyer_lawyer
ek_mahal_ho_sapno_ka	ek_mahal_ho_sapno_ka
the_lady_without_camelias	the_lady_without_camelias
slaughterhouse-five_(film)	slaughterhouse-five_(film)
jeevan_naiya	jeevan_naiya
perfect_day_(1929_film)	perfect_day_(1929_film)
i_delfini	i_delfini
bride_wars	bride_wars
of_human_bondage_(1964_film)	of_human_bondage_(1964_film)
la_mala_ordina	la_mala_ordina
three_to_tango	three_to_tango
deathrow_(film)	deathrow_(film)
the_miniver_story	the_miniver_story
city_on_fire_(1979_film)	city_on_fire_(1979_film)
lula,_son_of_brazil	lula,_son_of_brazil
the_runner_stumbles	the_runner_stumbles
hands_over_the_city	hands_over_the_city
an_ideal_husband_(1947_film)	an_ideal_husband_(1947_film)
darkness_(2002_film)	darkness_(2002_film)
june_bride	june_bride
soldier_of_orange	soldier_of_orange
yoga_for_indie_rockers	yoga_for_indie_rockers
hum_dil_de_chuke_sanam	hum_dil_de_chuke_sanam
the_rake's_progress_(film)	the_rake's_progress_(film)
blue_streak_(film)	blue_streak_(film)
the_black_godfather	the_black_godfather
batman_forever	batman_forever
hot_rods_to_hell	hot_rods_to_hell
adanggaman	adanggaman
jurmana	jurmana
julia_has_two_lovers	julia_has_two_lovers
ali_baba_goes_to_town	ali_baba_goes_to_town
the_danish_poet	the_danish_poet
a_walk_to_remember	a_walk_to_remember
the_10th_kingdom	the_10th_kingdom
driving_miss_wealthy	driving_miss_wealthy
conan_the_destroyer	conan_the_destroyer
razorback_(film)	razorback_(film)
10_(film)	10_(film)
young_winston	young_winston
the_other	the_other
meri_jung	meri_jung
the_search	the_search
humraaz	humraaz
nuns_on_the_run	nuns_on_the_run
murmur_of_the_heart	murmur_of_the_heart
dariya_dil	dariya_dil
may_fools	may_fools
why_we_bang	why_we_bang
muriel's_wedding	muriel's_wedding
supertwink	supertwink
man_with_a_shotgun	man_with_a_shotgun
pedicab_driver	pedicab_driver
adieu_blaireau	adieu_blaireau
groundhog_day_(film)	groundhog_day_(film)
zebra_lounge	zebra_lounge
burn_'em_up_barnes	burn_'em_up_barnes
pagal_nilavu	pagal_nilavu
alaudin	alaudin
27_missing_kisses	27_missing_kisses
house_of_the_long_shadows	house_of_the_long_shadows
jugnu	jugnu
proof_of_life	proof_of_life
jaanam_samjha_karo	jaanam_samjha_karo
siao_yu	siao_yu
kaun_(film)	kaun_(film)
un_indien_dans_la_ville	un_indien_dans_la_ville
betaab	betaab
judex_(1963_film)	judex_(1963_film)
double_jeopardy_(film)	double_jeopardy_(film)
the_pirates_of_penzance_(1983_film)	the_pirates_of_penzance_(1983_film)
cottage_to_let	cottage_to_let
a_little_trip_to_heaven	a_little_trip_to_heaven
nuvve_kavali	nuvve_kavali
there_will_be_blood	there_will_be_blood
helen_of_troy_(film)	helen_of_troy_(film)
head_of_state_(film)	head_of_state_(film)
silencing_mary	silencing_mary
astitva	astitva
around_the_bend	around_the_bend
virgin_witch	virgin_witch
abbiamo_vinto!	abbiamo_vinto!
beerfest	beerfest
they_came_to_a_city	they_came_to_a_city
the_world_of_suzie_wong_(film)	the_world_of_suzie_wong_(film)
the_fixer_(film)	the_fixer_(film)
thoroughbreds_don't_cry	thoroughbreds_don't_cry
beat_the_devil_(film)	beat_the_devil_(film)
uncle_buck	uncle_buck
green_dolphin_street	green_dolphin_street
geri's_game	geri's_game
shinjuku_incident	shinjuku_incident
blades_of_glory	blades_of_glory
atoll_k	atoll_k
the_barber_of_siberia	the_barber_of_siberia
the_roof_(film)	the_roof_(film)
the_opposite_of_sex	the_opposite_of_sex
victory_is_mine	victory_is_mine
zindagi_ek_juaa	zindagi_ek_juaa
manodu	manodu
ashes_of_paradise	ashes_of_paradise
nenjil_jil_jil	nenjil_jil_jil
puttin'_on_the_ritz_(film)	puttin'_on_the_ritz_(film)
adventures_into_digital_comics	adventures_into_digital_comics
encore_(1951_film)	encore_(1951_film)
american_gigolo	american_gigolo
indecent_proposal	indecent_proposal
rose_marie_(1936_film)	rose_marie_(1936_film)
sinful_davey	sinful_davey
booty_call	booty_call
umberto_d.	umberto_d.
the_mack	the_mack
heart_condition_(film)	heart_condition_(film)
daraar	daraar
scandal_in_sorrento	scandal_in_sorrento
scrooge_(1951_film)	scrooge_(1951_film)
bon_cop,_bad_cop	bon_cop,_bad_cop
crimes_at_the_dark_house	crimes_at_the_dark_house
hussar_ballad	hussar_ballad
kurumbu	kurumbu
the_elusive_pimpernel	the_elusive_pimpernel
fatal_instinct	fatal_instinct
it_happened_here	it_happened_here
the_lovemakers_(film)	the_lovemakers_(film)
king_cobra_(film)	king_cobra_(film)
man_of_the_house_(1995_film)	man_of_the_house_(1995_film)
the_holiday	the_holiday
besos_en_la_frente	besos_en_la_frente
gray_lady_down	gray_lady_down
aag_se_khelenge	aag_se_khelenge
the_jack_bull	the_jack_bull
bronco_billy	bronco_billy
crime_over_london	crime_over_london
hard_times_(1975_film)	hard_times_(1975_film)
homo_sapiens_1900	homo_sapiens_1900
the_hunchback_of_notre_dame_(1923_film)	the_hunchback_of_notre_dame_(1923_film)
sunday_dinner_for_a_soldier	sunday_dinner_for_a_soldier
tolly_lights	tolly_lights
kadawunu_poronduwa	kadawunu_poronduwa
haath_ki_safai	haath_ki_safai
abhilasha	abhilasha
captain_prabhakaran	captain_prabhakaran
a_kid_from_tibet	a_kid_from_tibet
americanizing_shelley	americanizing_shelley
torch_song_(film)	torch_song_(film)
the_machinist	the_machinist
dayavan	dayavan
hum_kisise_kum_nahin_(2002_film)	hum_kisise_kum_nahin_(2002_film)
rembrandt_(1936_film)	rembrandt_(1936_film)
kurulu_bedda	kurulu_bedda
hercules_in_the_haunted_world	hercules_in_the_haunted_world
sleepwalkers_(film)	sleepwalkers_(film)
garden_of_evil	garden_of_evil
tuck_everlasting_(2002_film)	tuck_everlasting_(2002_film)
angels_with_dirty_faces	angels_with_dirty_faces
stealing_home	stealing_home
parinda	parinda
i_do_(2006_film)	i_do_(2006_film)
la_bamba_(film)	la_bamba_(film)
the_strawberry_statement_(film)	the_strawberry_statement_(film)
peur_sur_la_ville	peur_sur_la_ville
time_after_time_(1979_film)	time_after_time_(1979_film)
aaron_cohen's_debt	aaron_cohen's_debt
ram_teri_ganga_maili	ram_teri_ganga_maili
triumph_of_the_spirit	triumph_of_the_spirit
honeymoon_academy	honeymoon_academy
the_last_remake_of_beau_geste	the_last_remake_of_beau_geste
gone_to_earth_(film)	gone_to_earth_(film)
road_(film)	road_(film)
once_upon_a_time_in_america	once_upon_a_time_in_america
green_fire	green_fire
raja_kumarudu	raja_kumarudu
heera_aur_pathar_(1964_film)	heera_aur_pathar_(1964_film)
dostana_(1980_film)	dostana_(1980_film)
veergati	veergati
bad_company_(2002_film)	bad_company_(2002_film)
our_man_in_jamaica	our_man_in_jamaica
avishkaar	avishkaar
il_sorpasso	il_sorpasso
the_chimp	the_chimp
you're_in_the_army_now	you're_in_the_army_now
unna_ja_nuuk	unna_ja_nuuk
kalathur_kannamma	kalathur_kannamma
a_small_domain	a_small_domain
the_ninth_gate	the_ninth_gate
the_caterpillar_wish	the_caterpillar_wish
journey_into_fear_(1943_film)	journey_into_fear_(1943_film)
kanchenjungha_(film)	kanchenjungha_(film)
new_waterford_girl	new_waterford_girl
mission_kashmir	mission_kashmir
out_of_the_wilderness	out_of_the_wilderness
back_street_(1941_film)	back_street_(1941_film)
love_phobia	love_phobia
ullaasam	ullaasam
house_on_haunted_hill	house_on_haunted_hill
a_return_to_salem's_lot	a_return_to_salem's_lot
anya's_bell	anya's_bell
sadma	sadma
buddha_gujjar	buddha_gujjar
clowns_spinning_hats	clowns_spinning_hats
very_happy_alexander	very_happy_alexander
men_with_brooms	men_with_brooms
judith_(1966_film)	judith_(1966_film)
the_passionate_plumber	the_passionate_plumber
time_of_love	time_of_love
shamus_(film)	shamus_(film)
kanoon	kanoon
lone_wolf_mcquade	lone_wolf_mcquade
slam_dance_(film)	slam_dance_(film)
chacha_bhatija	chacha_bhatija
13_rue_madeleine	13_rue_madeleine
the_yards	the_yards
heaven's_burning	heaven's_burning
the_namesake_(film)	the_namesake_(film)
at_five_in_the_afternoon	at_five_in_the_afternoon
gold_diggers_of_1933	gold_diggers_of_1933
vivir_intentando	vivir_intentando
otan_leipei_i_gata	otan_leipei_i_gata
bhajantrilu	bhajantrilu
talking_cock_the_movie	talking_cock_the_movie
navajo_joe	navajo_joe
vaseegara_(film)	vaseegara_(film)
kaakha_kaakha	kaakha_kaakha
death_watch	death_watch
dogfight_(film)	dogfight_(film)
priest_of_love	priest_of_love
captain_horatio_hornblower_r.n.	captain_horatio_hornblower_r.n.
definitely,_maybe	definitely,_maybe
anand_(1971_film)	anand_(1971_film)
burning_secret	burning_secret
berlin_alexanderplatz_(miniseries)	berlin_alexanderplatz_(miniseries)
tanner_on_tanner	tanner_on_tanner
hum_to_mohabbat_karega	hum_to_mohabbat_karega
panakkaran	panakkaran
mammo	mammo
the_case_of_the_scorpion's_tail	the_case_of_the_scorpion's_tail
i_love_your_work	i_love_your_work
den_farlige_alder	den_farlige_alder
the_missing_star	the_missing_star
the_flight_of_dragons	the_flight_of_dragons
down_periscope	down_periscope
not_as_a_stranger	not_as_a_stranger
marte_dam_tak	marte_dam_tak
cradle_of_fear	cradle_of_fear
the_saddest_music_in_the_world	the_saddest_music_in_the_world
battle_of_the_worlds	battle_of_the_worlds
apartado_de_correos_1001	apartado_de_correos_1001
sunny_(1941_film)	sunny_(1941_film)
evening_in_byzantium	evening_in_byzantium
stay_alive	stay_alive
enemy_at_the_gates	enemy_at_the_gates
the_mountain_road	the_mountain_road
the_great_raid	the_great_raid
american_flyers	american_flyers
aval_varuvala	aval_varuvala
godmother_(film)	godmother_(film)
curse_of_the_pink_panther	curse_of_the_pink_panther
mahanagaramlo_mayagadu	mahanagaramlo_mayagadu
the_sea_gull	the_sea_gull
the_war_at_home_(film)	the_war_at_home_(film)
zotz!	zotz!
circus_of_horrors	circus_of_horrors
el_amor_infiel	el_amor_infiel
adam_had_four_sons	adam_had_four_sons
devils_on_the_doorstep	devils_on_the_doorstep
flying_down_to_rio	flying_down_to_rio
in_the_park	in_the_park
isle_of_flowers	isle_of_flowers
an_american_tail	an_american_tail
heatstroke_(film)	heatstroke_(film)
burnt_by_the_sun	burnt_by_the_sun
tesis	tesis
five_finger_exercise_(film)	five_finger_exercise_(film)
the_marriage_of_maria_braun	the_marriage_of_maria_braun
sillunu_oru_kaadhal	sillunu_oru_kaadhal
mard_(1985_film)	mard_(1985_film)
underground_(1995_film)	underground_(1995_film)
zorro,_the_gay_blade	zorro,_the_gay_blade
horror_express	horror_express
four_riders	four_riders
the_wrong_move	the_wrong_move
ice_cold_in_alex	ice_cold_in_alex
my_life's_on_the_line	my_life's_on_the_line
una_americana_en_buenos_aires	una_americana_en_buenos_aires
paradise_(1982_film)	paradise_(1982_film)
goldie_gets_along	goldie_gets_along
a_matter_of_time_(film)	a_matter_of_time_(film)
la_primera_noche	la_primera_noche
the_woman_in_the_dunes	the_woman_in_the_dunes
the_night_heaven_fell	the_night_heaven_fell
banjo_the_woodpile_cat	banjo_the_woodpile_cat
buenas_noches,_buenos_aires	buenas_noches,_buenos_aires
kickin'_it_old_skool	kickin'_it_old_skool
the_spy_in_black	the_spy_in_black
the_gray_nun_of_belgium	the_gray_nun_of_belgium
a_shot_in_the_dark_(1964_film)	a_shot_in_the_dark_(1964_film)
for_a_lost_soldier	for_a_lost_soldier
a_pure_formality	a_pure_formality
creepshow	creepshow
manhattan_baby	manhattan_baby
namastey_london	namastey_london
hazaar_chaurasi_ki_maa	hazaar_chaurasi_ki_maa
the_empty_canvas	the_empty_canvas
the_eighth_day_(1996_film)	the_eighth_day_(1996_film)
lydia_(film)	lydia_(film)
death_of_a_gunfighter	death_of_a_gunfighter
shaolin_wooden_men	shaolin_wooden_men
once_around	once_around
lady_godiva_rides_again	lady_godiva_rides_again
psychomania	psychomania
a_jitney_elopement	a_jitney_elopement
the_godfather_(film_series)	the_godfather
lord_of_illusions	lord_of_illusions
the_mad_magician	the_mad_magician
the_blue_lagoon_(1949_film)	the_blue_lagoon_(1949_film)
mangala_vaathiyam	mangala_vaathiyam
do_nambar_ke_amir	do_nambar_ke_amir
parthen_rasithen	parthen_rasithen
neela_malargal	neela_malargal
day_of_the_idiots	day_of_the_idiots
the_black_bird	the_black_bird
the_wonders_of_aladdin	the_wonders_of_aladdin
i_will_not_confess	i_will_not_confess
the_beach_girls	the_beach_girls
augusto_anibal_quer_casar	augusto_anibal_quer_casar
wifemistress	wifemistress
zegen	zegen
nousukausi	nousukausi
spetters	spetters
fast_company_(1979_film)	fast_company_(1979_film)
broken_lance	broken_lance
arena_(1989_film)	arena_(1989_film)
the_great_adventures_of_captain_kidd	the_great_adventures_of_captain_kidd
la_vie_sur_terre	la_vie_sur_terre
i_mostri	i_mostri
mirrormask	mirrormask
wayne's_world_2	wayne's_world_2
nandu_(film)	nandu_(film)
detention_(2003_film)	detention_(2003_film)
terminal_station_(film)	terminal_station_(film)
almost_famous	almost_famous
dot_the_i	dot_the_i
paranoiac_(film)	paranoiac_(film)
legend_of_the_lost	legend_of_the_lost
bitter_moon	bitter_moon
gasbags	gasbags
sport_goofy_in_soccermania	sport_goofy_in_soccermania
along_the_way	along_the_way
starcrash	starcrash
vertical_limit	vertical_limit
the_strong_man	the_strong_man
singapore_dreaming	singapore_dreaming
aitbaar	aitbaar
thavamai_thavamirundhu	thavamai_thavamirundhu
narco_(film)	narco_(film)
il_brigante_musolino	il_brigante_musolino
benaam_(1974_film)	benaam_(1974_film)
page_miss_glory_(1935_film)	page_miss_glory_(1935_film)
mrs_henderson_presents	mrs_henderson_presents
the_bad_news_bears	the_bad_news_bears
abraxas,_guardian_of_the_universe	abraxas,_guardian_of_the_universe
made_of_honor	made_of_honor
divya_shakti	divya_shakti
9_to_5_(film)	9_to_5_(film)
last_train_from_gun_hill	last_train_from_gun_hill
manthan	manthan
ramchand_pakistani	ramchand_pakistani
mana_desam	mana_desam
thazhampoo	thazhampoo
tristan_&_isolde_(film)	tristan_&_isolde_(film)
when_the_last_sword_is_drawn	when_the_last_sword_is_drawn
hitogui_ama	hitogui_ama
kundun	kundun
pyaar_tune_kya_kiya	pyaar_tune_kya_kiya
the_ox-bow_incident	the_ox-bow_incident
forbidden_world	forbidden_world
nazar_(film)	nazar_(film)
the_monster_(1994_film)	the_monster_(1994_film)
manmadha_leelai	manmadha_leelai
three_roses	three_roses
pagale_vennela	pagale_vennela
a_piece_of_the_action_(film)	a_piece_of_the_action_(film)
so_long_at_the_fair	so_long_at_the_fair
a_dangerous_life	a_dangerous_life
fidibus	fidibus
dil_ka_rishta	dil_ka_rishta
gie	gie
speaking_parts	speaking_parts
indru	indru
a_winter_tan	a_winter_tan
striking_distance	striking_distance
lady_liberty_(film)	lady_liberty_(film)
with_the_marines_at_tarawa	with_the_marines_at_tarawa
the_pinchcliffe_grand_prix	the_pinchcliffe_grand_prix
daughter_of_don_q	daughter_of_don_q
junoon_(1992_film)	junoon_(1992_film)
japanese_story	japanese_story
barsaat_(1995_film)	barsaat_(1995_film)
the_photographical_congress_arrives_in_lyon	the_photographical_congress_arrives_in_lyon
big_momma's_house_2	big_momma's_house_2
kyun_tum_say_itna_pyar_hai	kyun_tum_say_itna_pyar_hai
sangee	sangee
let_george_do_it!	let_george_do_it!
the_son_of_dr._jekyll	the_son_of_dr._jekyll
the_bird_with_the_crystal_plumage	the_bird_with_the_crystal_plumage
sunday_school_musical	sunday_school_musical
kaadhal_mannan	kaadhal_mannan
the_king_of_masks	the_king_of_masks
it_shouldn't_happen_to_a_vet	it_shouldn't_happen_to_a_vet
agent_cody_banks	agent_cody_banks
the_foxes_of_harrow	the_foxes_of_harrow
his_new_profession	his_new_profession
invitation_to_a_gunfighter	invitation_to_a_gunfighter
camp_nowhere	camp_nowhere
the_watermelon_woman	the_watermelon_woman
the_amityville_horror_(2005_film)	the_amityville_horror_(2005_film)
the_alligator_people	the_alligator_people
how_i_got_into_college	how_i_got_into_college
the_working_class_goes_to_heaven	the_working_class_goes_to_heaven
kannathil_muthamittal	kannathil_muthamittal
bohaterowie_sybiru	bohaterowie_sybiru
leatherheads	leatherheads
man_of_the_moment_(1955_film)	man_of_the_moment_(1955_film)
trishul_(film)	trishul_(film)
23_paces_to_baker_street	23_paces_to_baker_street
senso_(film)	senso_(film)
paruva_kaalam	paruva_kaalam
kikujiro	kikujiro
pussycat,_pussycat,_i_love_you	pussycat,_pussycat,_i_love_you
i_love_you_again	i_love_you_again
returner	returner
dhee	dhee
the_woman_in_the_rumor	the_woman_in_the_rumor
karma_(1986_film)	karma_(1986_film)
dangerous_when_wet	dangerous_when_wet
lease_wife	lease_wife
the_great_gabbo	the_great_gabbo
deadly_prey	deadly_prey
fille_du_peuple	fille_du_peuple
paradise_now	paradise_now
soch	soch
sami_swoi	sami_swoi
abuso_de_confianza	abuso_de_confianza
the_order_(2003_film)	the_order_(2003_film)
for_your_consideration_(film)	for_your_consideration_(film)
adavi_donga	adavi_donga
bach's_fight_for_freedom	bach's_fight_for_freedom
letter_to_brezhnev	letter_to_brezhnev
living_proof_(film)	living_proof_(film)
farishtay	farishtay
fanny_(1961_film)	fanny_(1961_film)
double_exposure_(1944_film)	double_exposure_(1944_film)
dulhan_hum_le_jayenge	dulhan_hum_le_jayenge
new_(film)	new_(film)
the_pumpkin_karver	the_pumpkin_karver
two_weeks_with_love	two_weeks_with_love
marigold_(2007_film)	marigold_(2007_film)
the_learning_tree	the_learning_tree
the_crimson_permanent_assurance	the_crimson_permanent_assurance
the_fish_that_saved_pittsburgh	the_fish_that_saved_pittsburgh
inch'allah_dimanche	inch'allah_dimanche
starsky_&_hutch_(film)	starsky_&_hutch_(film)
mediterraneo	mediterraneo
the_long_kiss_goodnight	the_long_kiss_goodnight
white_mischief_(film)	white_mischief_(film)
scirocco_(film)	scirocco_(film)
kings_row	kings_row
grizzly_man	grizzly_man
the_story_of_a_three-day_pass	the_story_of_a_three-day_pass
handel's_last_chance	handel's_last_chance
samudhiram	samudhiram
the_lady_of_musashino	the_lady_of_musashino
adolescencia	adolescencia
love_(2008_bengali_film)	love_(2008_bengali_film)
clerks	clerks
ghost_train_international	ghost_train_international
the_lady_eve	the_lady_eve
buddhas_barn	buddhas_barn
trouble_makers	trouble_makers
horrors_of_the_black_museum	horrors_of_the_black_museum
a_severa_(film)	a_severa_(film)
jack-jack_attack	jack-jack_attack
distant_shadow	distant_shadow
hiroshima_mon_amour	hiroshima_mon_amour
down_argentine_way	down_argentine_way
so_well_remembered	so_well_remembered
hostage_for_a_day	hostage_for_a_day
journeys_with_george	journeys_with_george
sayew	sayew
the_pride_of_st._louis	the_pride_of_st._louis
lost_in_america	lost_in_america
hard_boiled	hard_boiled
cowboy_(1958_film)	cowboy_(1958_film)
voice_without_a_shadow	voice_without_a_shadow
alice_in_the_cities	alice_in_the_cities
the_baxter	the_baxter
silent_tongue	silent_tongue
aadat_se_majboor	aadat_se_majboor
the_art_of_getting_along	the_art_of_getting_along
tender_mercies	tender_mercies
the_cassandra_crossing	the_cassandra_crossing
the_alamo_(1960_film)	the_alamo_(1960_film)
coolie_(1983_hindi_film)	coolie_(1983_hindi_film)
a_rumor_of_angels	a_rumor_of_angels
shanghai_grand	shanghai_grand
karutha_pakshikal	karutha_pakshikal
slaves_of_new_york	slaves_of_new_york
satya_(film)	satya_(film)
the_passion_of_the_christ	the_passion_of_the_christ
mesmer_(film)	mesmer_(film)
ghulami	ghulami
the_darjeeling_limited	the_darjeeling_limited
nau_do_gyarah	nau_do_gyarah
shadow_company	shadow_company
othello_(1995_film)	othello_(1995_film)
the_dogs_of_war_(film)	the_dogs_of_war_(film)
boa_vs._python	boa_vs._python
suspect_zero	suspect_zero
dentist_on_the_job	dentist_on_the_job
a_ticket_to_tomahawk	a_ticket_to_tomahawk
bang_the_drum_slowly_(film)	bang_the_drum_slowly_(film)
never_die_alone	never_die_alone
premonition_(2007_film)	premonition_(2007_film)
otello_(1986_film)	otello_(1986_film)
street_trash	street_trash
it_takes_two_(1982_film)	it_takes_two_(1982_film)
maria_marten,_or_the_murder_in_the_red_barn	maria_marten,_or_the_murder_in_the_red_barn
taal_(film)	taal_(film)
feardotcom	feardotcom
brown_on_resolution_(film)	brown_on_resolution_(film)
star!_(film)	star!_(film)
war_requiem_(film)	war_requiem_(film)
the_grissom_gang	the_grissom_gang
the_crucible_(1957_film)	the_crucible_(1957_film)
foul_play_(1978_film)	foul_play_(1978_film)
merry_andrew_(film)	merry_andrew_(film)
ever_since_eve	ever_since_eve
cairo_(film)	cairo_(film)
beverly_hills_ninja	beverly_hills_ninja
the_yakuza	the_yakuza
natchathiram	natchathiram
happy,_texas_(film)	happy,_texas_(film)
it's_a_bikini_world	it's_a_bikini_world
a_frozen_flower	a_frozen_flower
it's_always_fair_weather	it's_always_fair_weather
red_dust	red_dust
the_girl_in_the_crowd	the_girl_in_the_crowd
the_shrimp_on_the_barbie	the_shrimp_on_the_barbie
confirm_or_deny	confirm_or_deny
bob_roberts	bob_roberts
the_devil's_child	the_devil's_child
daughters_courageous	daughters_courageous
jaise_ko_taisa	jaise_ko_taisa
aikalainen	aikalainen
the_walls_of_malapaga	the_walls_of_malapaga
yaarana_(1981_film)	yaarana_(1981_film)
roaring_years	roaring_years
i'll_never_forget_what's'isname	i'll_never_forget_what's'isname
thway	thway
cradle_will_rock	cradle_will_rock
heima	heima
qayamat	qayamat
massacre_in_rome	massacre_in_rome
the_guru_(1969_film)	the_guru_(1969_film)
premi	premi
the_spanish_gardener_(film)	the_spanish_gardener_(film)
bombay_by_nite	bombay_by_nite
my_mom's_new_boyfriend	my_mom's_new_boyfriend
places_in_the_heart	places_in_the_heart
holy_matrimony_(1943_film)	holy_matrimony_(1943_film)
ullam_ketkumae	ullam_ketkumae
love_stories	love_stories
stallion_road	stallion_road
thunder_in_the_sun	thunder_in_the_sun
tomar_jonyo	tomar_jonyo
pom_poko	pom_poko
rakht	rakht
one_way_passage	one_way_passage
north_korean_guys	north_korean_guys
four_of_the_apocalypse	four_of_the_apocalypse
don_camillo_in_moscow	don_camillo_in_moscow
the_egyptian_(film)	the_egyptian_(film)
once_more,_with_feeling!	once_more,_with_feeling!
khaidi	khaidi
yanks	yanks
jhankaar_beats	jhankaar_beats
tenebrae_(film)	tenebrae_(film)
le_distrait	le_distrait
bombay_boys	bombay_boys
broadway_(1929_film)	broadway_(1929_film)
the_bridge_of_san_luis_rey_(2004_film)	the_bridge_of_san_luis_rey_(2004_film)
l'age_d'or	l'age_d'or
reign_of_fire_(film)	reign_of_fire_(film)
eskimo_(film)	eskimo_(film)
a_lady's_morals	a_lady's_morals
rabid	rabid
ucho	ucho
the_greeks_had_a_word_for_them	the_greeks_had_a_word_for_them
hell_divers	hell_divers
it_should_happen_to_you	it_should_happen_to_you
heller_in_pink_tights	heller_in_pink_tights
student_seduction	student_seduction
hatya	hatya
bedtime_for_bonzo	bedtime_for_bonzo
dusha	dusha
gandhi,_my_father	gandhi,_my_father
orgy_of_the_dead	orgy_of_the_dead
too_hot_to_handle_(1977_film)	too_hot_to_handle_(1977_film)
the_alarmist	the_alarmist
the_great_ecstasy_of_woodcarver_steiner	the_great_ecstasy_of_woodcarver_steiner
kelly's_heroes	kelly's_heroes
robocop	robocop
teen_wolf_too	teen_wolf_too
silsila_hai_pyar_ka	silsila_hai_pyar_ka
guns_at_batasi	guns_at_batasi
takkari_donga	takkari_donga
al-zawjah_al-azra'	al-zawjah_al-azra'
goopy_gyne_bagha_byne	goopy_gyne_bagha_byne
pr_girls	pr_girls
the_league_of_extraordinary_gentlemen_(film)	the_league_of_extraordinary_gentlemen_(film)
ada_(film)	ada_(film)
home_on_the_range_(2004_film)	home_on_the_range_(2004_film)
the_roman_spring_of_mrs._stone	the_roman_spring_of_mrs._stone
christopher_columbus_(1949_film)	christopher_columbus_(1949_film)
luxury_liner_(film)	luxury_liner_(film)
rajnigandha	rajnigandha
drake's_venture	drake's_venture
all_the_way,_boys	all_the_way,_boys
hello_friend	hello_friend
accattone	accattone
side_out	side_out
voces_inocentes	voces_inocentes
fiza	fiza
goodbye_pork_pie	goodbye_pork_pie
nati_stanchi	nati_stanchi
eleni_(film)	eleni_(film)
familien_pille_som_spejdere	familien_pille_som_spejdere
hurricane_(1979_film)	hurricane_(1979_film)
wu_yen	wu_yen
bill_&_ted's_bogus_journey	bill_&_ted's_bogus_journey
swimming_upstream	swimming_upstream
the_lion_has_wings	the_lion_has_wings
carefree_(film)	carefree_(film)
king_david_(film)	king_david_(film)
reach_for_glory	reach_for_glory
cabin_in_the_sky	cabin_in_the_sky
the_desert_hawk	the_desert_hawk
gabriel_over_the_white_house	gabriel_over_the_white_house
boom!_(film)	boom!_(film)
ilzaam	ilzaam
remember_the_night	remember_the_night
jacob_two_two_meets_the_hooded_fang	jacob_two_two_meets_the_hooded_fang
airport_(1970_film)	airport_(1970_film)
born_to_dance	born_to_dance
bingo_bongo	bingo_bongo
the_eel_(film)	the_eel_(film)
los_amores_de_laurita	los_amores_de_laurita
wielka_droga	wielka_droga
roommates_(1995_film)	roommates_(1995_film)
the_seduction_of_mimi	the_seduction_of_mimi
case_for_a_rookie_hangman	case_for_a_rookie_hangman
a_halfway_house_christmas	a_halfway_house_christmas
khaan_dost	khaan_dost
a_huey_p._newton_story	a_huey_p._newton_story
thunderbolt!	thunderbolt!
flic_story	flic_story
island_of_lost_women	island_of_lost_women
je_bho_ramrai_bho	je_bho_ramrai_bho
go_to_hell,_hoodlums!	go_to_hell,_hoodlums!
the_siege_of_the_alcazar	the_siege_of_the_alcazar
roselyne_et_les_lions	roselyne_et_les_lions
crouching_tiger,_hidden_dragon	crouching_tiger,_hidden_dragon
thiruda_thiruda	thiruda_thiruda
stealing_harvard	stealing_harvard
petulia	petulia
heartbreak_hotel_(film)	heartbreak_hotel_(film)
last_tango_in_paris	last_tango_in_paris
anbe_aaruyire_(2005_film)	anbe_aaruyire_(2005_film)
sanning_eller_konsekvens	sanning_eller_konsekvens
living_out_loud	living_out_loud
the_master_touch	the_master_touch
indigo_(film)	indigo_(film)
termini_station_(film)	termini_station_(film)
thirteen_women	thirteen_women
jaan_se_pyaara	jaan_se_pyaara
the_voice_of_the_moon	the_voice_of_the_moon
amar_prem	amar_prem
the_millionairess	the_millionairess
eddie_(film)	eddie_(film)
adventures_of_sir_galahad	adventures_of_sir_galahad
near_dark	near_dark
the_student_prince_(film)	the_student_prince_(film)
tornado!	tornado!
hurlyburly_(film)	hurlyburly_(film)
nater_guru	nater_guru
hero_no._1	hero_no._1
the_curve_(film)	the_curve_(film)
mccabe_&_mrs._miller	mccabe_&_mrs._miller
the_sheltering_sky_(film)	the_sheltering_sky_(film)
the_proud_valley	the_proud_valley
how_i_unleashed_world_war_ii	how_i_unleashed_world_war_ii
the_new_adventures_of_tarzan	the_new_adventures_of_tarzan
legend_of_the_eight_samurai	legend_of_the_eight_samurai
chor_machaye_shor	chor_machaye_shor
the_color_of_pomegranates	the_color_of_pomegranates
vishwasghaat	vishwasghaat
first_picture	first_picture
variola_vera	variola_vera
dushman_duniya_ka	dushman_duniya_ka
swarg	swarg
small_town_rivals	small_town_rivals
aao_pyaar_karen	aao_pyaar_karen
young_cassidy	young_cassidy
the_absent-minded_professor	the_absent-minded_professor
captain_ron	captain_ron
in_too_deep_(film)	in_too_deep_(film)
jack_brown_genius	jack_brown_genius
bullet_in_the_head	bullet_in_the_head
a_good_man_in_africa	a_good_man_in_africa
the_bride_came_c.o.d.	the_bride_came_c.o.d.
summer_lovers	summer_lovers
aik_aur_love_story	aik_aur_love_story
alina_(film)	alina_(film)
on_the_doll	on_the_doll
salakhain	salakhain
murder,_inc._(film)	murder,_inc._(film)
the_leopard_(1963_film)	the_leopard_(1963_film)
moscow_does_not_believe_in_tears	moscow_does_not_believe_in_tears
destry_rides_again	destry_rides_again
the_fighting_marines	the_fighting_marines
terror_train	terror_train
peter_ibbetson	peter_ibbetson
top_gun	top_gun
krodhi	krodhi
ecstasy_of_the_angels	ecstasy_of_the_angels
my_teacher,_mr._kim	my_teacher,_mr._kim
zamaana_deewana	zamaana_deewana
raju_chacha	raju_chacha
white_sun_of_the_desert	white_sun_of_the_desert
the_wooden_camera	the_wooden_camera
de_lift	de_lift
eve's_bayou	eve's_bayou
rookie_of_the_year_(film)	rookie_of_the_year_(film)
major_payne	major_payne
dhill	dhill
la_tutf'e_al-shams	la_tutf'e_al-shams
death_in_venice_(film)	death_in_venice_(film)
before_the_revolution	before_the_revolution
blue_in_the_face	blue_in_the_face
sound_of_the_sea	sound_of_the_sea
the_belles_of_st_trinian's	the_belles_of_st_trinian's
ek_ladka_ek_ladki	ek_ladka_ek_ladki
poppoya	poppoya
jab_pyaar_kisise_hota_hai	jab_pyaar_kisise_hota_hai
the_viking_watch_of_the_danish_seaman	the_viking_watch_of_the_danish_seaman
chennai_600028	chennai_600028
my_giant	my_giant
champion_(2002_film)	champion_(2002_film)
i.o.u.s.a.	i.o.u.s.a.
maya_machhindra	maya_machhindra
strange_behavior	strange_behavior
marilena_from_p7	marilena_from_p7
the_horrible_dr._hichcock	the_horrible_dr._hichcock
the_next_voice_you_hear...	the_next_voice_you_hear...
the_happy_thieves	the_happy_thieves
henna_(film)	henna_(film)
possession_(2002_film)	possession_(2002_film)
the_new_centurions	the_new_centurions
sweet_'n_short	sweet_'n_short
london_town_(film)	london_town_(film)
skin_game	skin_game
oru_kaidhiyin_diary	oru_kaidhiyin_diary
gehenna_(film)	gehenna_(film)
virumbugiren	virumbugiren
supahpapalicious	supahpapalicious
hail_the_conquering_hero	hail_the_conquering_hero
aberration_(film)	aberration_(film)
tiara_tahiti	tiara_tahiti
imagining_argentina_(film)	imagining_argentina_(film)
my_super_ex-girlfriend	my_super_ex-girlfriend
the_andromeda_strain_(film)	the_andromeda_strain_(film)
the_pizza_triangle	the_pizza_triangle
the_bucket_list	the_bucket_list
aadmi_khilona_hai	aadmi_khilona_hai
the_caretakers	the_caretakers
can't_buy_me_love_(film)	can't_buy_me_love_(film)
the_enchanted_drawing	the_enchanted_drawing
majboor_(1974_film)	majboor_(1974_film)
a_cool,_dry_place	a_cool,_dry_place
mumbai_se_aaya_mera_dost	mumbai_se_aaya_mera_dost
ilamai_oonjal_aadukirathu	ilamai_oonjal_aadukirathu
28_weeks_later	28_weeks_later
fools_for_scandal	fools_for_scandal
the_gentleman_(film)	the_gentleman_(film)
lyubimetz_13	lyubimetz_13
the_oil_gush_in_balakhany	the_oil_gush_in_balakhany
madrasi_(2006_film)	madrasi_(2006_film)
dragonfly_(2002_film)	dragonfly_(2002_film)
la_menace	la_menace
backbeat_(film)	backbeat_(film)
idaya_kovil	idaya_kovil
karunamayudu	karunamayudu
vera_cruz_(film)	vera_cruz_(film)
mashaal	mashaal
rider_on_the_rain	rider_on_the_rain
the_music_box	the_music_box
purely_belter	purely_belter
nobody_runs_forever	nobody_runs_forever
mukh_o_mukhosh	mukh_o_mukhosh
school_daze	school_daze
bad_company_(1972_film)	bad_company_(1972_film)
things_we_lost_in_the_fire	things_we_lost_in_the_fire
dr._dolittle_2	dr._dolittle_2
khatarnak	khatarnak
epic_movie	epic_movie
kabuliwala_(1961_film)	kabuliwala_(1961_film)
i_want_to_be_a_pilot	i_want_to_be_a_pilot
the_innocent_(1976_film)	the_innocent_(1976_film)
the_score_(2001_film)	the_score_(2001_film)
jeg_har_elsket_og_levet	jeg_har_elsket_og_levet
doctor_detroit	doctor_detroit
steel_magnolias	steel_magnolias
theirs_is_the_glory	theirs_is_the_glory
itlu_sravani_subramanyam	itlu_sravani_subramanyam
cold_sweat_(1970_film)	cold_sweat_(1970_film)
hand_of_death	hand_of_death
shadowless_sword	shadowless_sword
welcome,_reverend!	welcome,_reverend!
the_safety_of_objects	the_safety_of_objects
annapolis_(film)	annapolis_(film)
the_atomic_kid	the_atomic_kid
amar_akbar_anthony	amar_akbar_anthony
deadline_auto_theft	deadline_auto_theft
snake_&_crane_arts_of_shaolin	snake_&_crane_arts_of_shaolin
kismet_(1930_film)	kismet_(1930_film)
aag_ka_gola	aag_ka_gola
7g_rainbow_colony	7g_rainbow_colony
a_man_apart	a_man_apart
secrets_of_women	secrets_of_women
eddie_macon's_run	eddie_macon's_run
saat_hindustani	saat_hindustani
mettukudi	mettukudi
bouncing_babies	bouncing_babies
black_legion_(film)	black_legion_(film)
baba_(2002_film)	baba_(2002_film)
azuloscurocasinegro	azuloscurocasinegro
ishq_vishk	ishq_vishk
the_cat_from_outer_space	the_cat_from_outer_space
the_cat_o'_nine_tails	the_cat_o'_nine_tails
the_day_the_earth_caught_fire	the_day_the_earth_caught_fire
sangdil_sanam	sangdil_sanam
the_manitou	the_manitou
el_profesor_hippie	el_profesor_hippie
warm_water_under_a_red_bridge	warm_water_under_a_red_bridge
she_done_him_wrong	she_done_him_wrong
blackout_effect	blackout_effect
andy_hardy_meets_debutante	andy_hardy_meets_debutante
all_of_me_(1984_film)	all_of_me_(1984_film)
aeg_elada,_aeg_armastada	aeg_elada,_aeg_armastada
doosri_sita	doosri_sita
ek_aur_ek_gyarah	ek_aur_ek_gyarah
awake_(film)	awake_(film)
duck,_you_sucker!	duck,_you_sucker!
red_desert_(film)	red_desert_(film)
grace_is_gone	grace_is_gone
pyaar_mein_twist	pyaar_mein_twist
that_cold_day_in_the_park	that_cold_day_in_the_park
the_happiest_days_of_your_life	the_happiest_days_of_your_life
dulaara	dulaara
jheel_ke_us_paar	jheel_ke_us_paar
man_trouble	man_trouble
tattoo_(1981_film)	tattoo_(1981_film)
hote_hote_pyar_ho_gaya	hote_hote_pyar_ho_gaya
martin_roumagnac	martin_roumagnac
jesus_of_montreal	jesus_of_montreal
basic_(film)	basic_(film)
weapons_of_mass_distraction	weapons_of_mass_distraction
the_last_day_of_summer	the_last_day_of_summer
en_mana_vaanil	en_mana_vaanil
submarine_command	submarine_command
the_abc_of_love	the_abc_of_love
ice_castles	ice_castles
fly_away_home	fly_away_home
sliding_doors	sliding_doors
yaad_rakhegi_duniya	yaad_rakhegi_duniya
stowaway_in_the_sky	stowaway_in_the_sky
wyoming_(1940_film)	wyoming_(1940_film)
oh,_mr_porter!	oh,_mr_porter!
alien_adventure	alien_adventure
the_male_animal	the_male_animal
redbelt	redbelt
butterfield_8	butterfield_8
the_comancheros_(film)	the_comancheros_(film)
the_proposition	the_proposition
shaan_(film)	shaan_(film)
little_big_league	little_big_league
bulletproof_(1996_film)	bulletproof_(1996_film)
izzatdaar	izzatdaar
stroszek	stroszek
eight_below	eight_below
u-carmen_ekhayelitsha	u-carmen_ekhayelitsha
broken_flowers	broken_flowers
sommersby	sommersby
anything_else	anything_else
arul	arul
call_of_the_cuckoo	call_of_the_cuckoo
body_troopers	body_troopers
the_deep_six	the_deep_six
snake_eyes_(film)	snake_eyes_(film)
kadhal_samrajyam	kadhal_samrajyam
woman_obsessed	woman_obsessed
vroom_vroom_vroooom	vroom_vroom_vroooom
fire_maidens_from_outer_space	fire_maidens_from_outer_space
zeisters	zeisters
indrajeet	indrajeet
the_octagon_(film)	the_octagon_(film)
blondie_of_the_follies	blondie_of_the_follies
a_business_affair	a_business_affair
the_clowns_(film)	the_clowns_(film)
the_mad_genius	the_mad_genius
torment_(1944_film)	torment_(1944_film)
god_reward_you	god_reward_you
while_she_was_out	while_she_was_out
a_home_at_the_end_of_the_world_(film)	a_home_at_the_end_of_the_world_(film)
massacre_time	massacre_time
big_bad_love	big_bad_love
crime,_inc.	crime,_inc.
the_magic_cloak_of_oz	the_magic_cloak_of_oz
tower_of_evil	tower_of_evil
miracle_in_milan	miracle_in_milan
hour_of_the_wolf	hour_of_the_wolf
bomb_the_system	bomb_the_system
abdulla_the_great	abdulla_the_great
political_rowdy	political_rowdy
falling_down	falling_down
flight_of_the_phoenix_(2004_film)	flight_of_the_phoenix_(2004_film)
the_snake_pit	the_snake_pit
arasilangkumari	arasilangkumari
kantri	kantri
the_karaoke_king	the_karaoke_king
love_me_if_you_dare	love_me_if_you_dare
catlow	catlow
next_of_kin_(1984_film)	next_of_kin_(1984_film)
sanam_bewafa	sanam_bewafa
winter_meeting	winter_meeting
better_than_chocolate	better_than_chocolate
margot_at_the_wedding	margot_at_the_wedding
aaj_ka_arjun	aaj_ka_arjun
the_traffic_policeman	the_traffic_policeman
long_time_dead	long_time_dead
prem_shakti	prem_shakti
minbo	minbo
cheerleader_queens	cheerleader_queens
aap_ke_saath	aap_ke_saath
chaturanga_(film)	chaturanga_(film)
the_private_eyes_(1980_film)	the_private_eyes_(1980_film)
run_(2004_film)	run_(2004_film)
the_ring_virus	the_ring_virus
until_the_end_of_the_world	until_the_end_of_the_world
sixty_million_dollar_man	sixty_million_dollar_man
waltzing_regitze	waltzing_regitze
the_entity	the_entity
the_best_of_times_(film)	the_best_of_times_(film)
vayasu_pilichindi	vayasu_pilichindi
the_towering_inferno	the_towering_inferno
death_rides_a_horse	death_rides_a_horse
jo_darr_gya_woh_marr_gya	jo_darr_gya_woh_marr_gya
the_monkey's_uncle	the_monkey's_uncle
heroes_of_the_flames	heroes_of_the_flames
disco_dancer	disco_dancer
flight_of_the_navigator	flight_of_the_navigator
agent_wild_duck	agent_wild_duck
uncommon_valor	uncommon_valor
the_warlords	the_warlords
madol_duwa	madol_duwa
young_einstein	young_einstein
martian_child	martian_child
taste_of_cherry	taste_of_cherry
remember_the_day	remember_the_day
a_woman's_vengeance	a_woman's_vengeance
hei_de_vencer	hei_de_vencer
the_millennial_bee	the_millennial_bee
honeymoon_travels_pvt._ltd.	honeymoon_travels_pvt._ltd.
naug_ma_kja_kyay	naug_ma_kja_kyay
westward_the_women	westward_the_women
april_fool's_day_(1986_film)	april_fool's_day_(1986_film)
i_was_monty's_double_(film)	i_was_monty's_double_(film)
pattikkaattu_raja	pattikkaattu_raja
the_business_of_fancydancing	the_business_of_fancydancing
the_best_little_whorehouse_in_texas_(film)	the_best_little_whorehouse_in_texas_(film)
dancing_pirate	dancing_pirate
variety_lights	variety_lights
but_forever_in_my_mind	but_forever_in_my_mind
this_time_for_keeps	this_time_for_keeps
seven_(1995_film)	seven_(1995_film)
raja_vikramarka	raja_vikramarka
medicine_man_(film)	medicine_man_(film)
hard_target	hard_target
bitch_slap	bitch_slap
a_warm_december	a_warm_december
chocolate_(2001_film)	chocolate_(2001_film)
yield_to_the_night	yield_to_the_night
without_evidence	without_evidence
the_dark_corner	the_dark_corner
manoranjan	manoranjan
selva_(film)	selva_(film)
wild_child_(film)	wild_child_(film)
aragami	aragami
tales_that_witness_madness	tales_that_witness_madness
vaazhthugal	vaazhthugal
student_no.1	student_no.1
airport_'77	airport_'77
thumb_wars	thumb_wars
the_cartier_affair	the_cartier_affair
short_cuts	short_cuts
tricky_brains	tricky_brains
tumi_kar	tumi_kar
lone_rider	lone_rider
les_tontons_flingueurs	les_tontons_flingueurs
mighty_joe_young_(1949_film)	mighty_joe_young_(1949_film)
bert_rigby,_you're_a_fool	bert_rigby,_you're_a_fool
joroo_ka_ghulam	joroo_ka_ghulam
shibaji	shibaji
i'm_not_there	i'm_not_there
son_of_the_shark	son_of_the_shark
the_fugitive_(1947_film)	the_fugitive_(1947_film)
white_nights_(1985_film)	white_nights_(1985_film)
jhoom_barabar_jhoom	jhoom_barabar_jhoom
this_man_must_die	this_man_must_die
unfaithfully_yours_(1984_film)	unfaithfully_yours_(1984_film)
49th_parallel_(film)	49th_parallel_(film)
the_dog_who_stopped_the_war	the_dog_who_stopped_the_war
la_luna_(1979_film)	la_luna_(1979_film)
the_golden_arrow_(1936_film)	the_golden_arrow_(1936_film)
aika_tappaa	aika_tappaa
nidhanaya	nidhanaya
as_white_as_in_snow	as_white_as_in_snow
wild_strawberries_(film)	wild_strawberries_(film)
mujrim	mujrim
nynne	nynne
bye_bye_monkey	bye_bye_monkey
cast_a_giant_shadow	cast_a_giant_shadow
sye_(2004_film)	sye_(2004_film)
together_(2002_film)	together_(2002_film)
na_tum_jaano_na_hum	na_tum_jaano_na_hum
ooty_varai_uravu	ooty_varai_uravu
pasivadi_pranam	pasivadi_pranam
angel_in_my_pocket	angel_in_my_pocket
city_of_the_living_dead	city_of_the_living_dead
a_kiss_from_mary_pickford	a_kiss_from_mary_pickford
desa_nisa	desa_nisa
say_it_with_songs	say_it_with_songs
beijing_bicycle	beijing_bicycle
arabikkatha	arabikkatha
ladyhawke	ladyhawke
spasms	spasms
malta_story	malta_story
kareeb	kareeb
thuldai	thuldai
lawn_dogs	lawn_dogs
norma_jean_&_marilyn	norma_jean_&_marilyn
an_inconvenient_truth	an_inconvenient_truth
after_the_wedding	after_the_wedding
prem_rog	prem_rog
lisztomania_(film)	lisztomania_(film)
genghis_khan_(1965_film)	genghis_khan_(1965_film)
joshua_(2002_film)	joshua_(2002_film)
men_don't_leave	men_don't_leave
uwiedziona	uwiedziona
tengers	tengers
the_blood_of_heroes	the_blood_of_heroes
treasure_of_san_gennaro	treasure_of_san_gennaro
chantabbai	chantabbai
god_of_gamblers_returns	god_of_gamblers_returns
persiane_chiuse	persiane_chiuse
the_little_theatre_of_jean_renoir	the_little_theatre_of_jean_renoir
anna_of_brooklyn	anna_of_brooklyn
a_bridge_too_far_(film)	a_bridge_too_far_(film)
el_caballo_del_pueblo	el_caballo_del_pueblo
world_without_sun	world_without_sun
final_destination	final_destination_3
final_destination	the_final_destination
final_destination	final_destination
murder_by_numbers	murder_by_numbers
winter_passing	winter_passing
bengal_brigade	bengal_brigade
aegan	aegan
the_great_alaskan_mystery	the_great_alaskan_mystery
pammal_k._sambandam	pammal_k._sambandam
early_summer	early_summer
the_wild_world_of_batwoman	the_wild_world_of_batwoman
anbe_vaa	anbe_vaa
germany,_pale_mother	germany,_pale_mother
neel_rajar_deshe	neel_rajar_deshe
the_curse_of_the_werewolf	the_curse_of_the_werewolf
kissi_se_na_kehna	kissi_se_na_kehna
good_will_hunting	good_will_hunting
gate_of_flesh	gate_of_flesh
a_better_tomorrow	a_better_tomorrow
the_long_walk_home	the_long_walk_home
bandidas	bandidas
barney's_great_adventure	barney's_great_adventure
the_munsters'_scary_little_christmas	the_munsters'_scary_little_christmas
the_gauntlet_(film)	the_gauntlet_(film)
jindabyne_(film)	jindabyne_(film)
satya_in_love	satya_in_love
club_de_rencontres	club_de_rencontres
hello_brother_(1999_film)	hello_brother_(1999_film)
ashta_chamma	ashta_chamma
bloodbath_at_the_house_of_death	bloodbath_at_the_house_of_death
salgira	salgira
a_quiet_day_in_belfast	a_quiet_day_in_belfast
lt._robin_crusoe,_u.s.n.	lt._robin_crusoe,_u.s.n.
in_the_land_of_women	in_the_land_of_women
one_hour_photo	one_hour_photo
a_zed_&_two_noughts	a_zed_&_two_noughts
the_mystery_of_the_marie_celeste	the_mystery_of_the_marie_celeste
002_operazione_luna	002_operazione_luna
showgirls	showgirls
king_arthur_(film)	king_arthur_(film)
a_scene_at_the_sea	a_scene_at_the_sea
don't_say_a_word	don't_say_a_word
thulluvadho_ilamai	thulluvadho_ilamai
paulo_e_virginia	paulo_e_virginia
love_(1991_film)	love_(1991_film)
kabhi_pyar_na_karna	kabhi_pyar_na_karna
body_rock	body_rock
tik_tik_tik	tik_tik_tik
the_hand_in_the_trap	the_hand_in_the_trap
let_sleeping_cops_lie	let_sleeping_cops_lie
birdy_(film)	birdy_(film)
the_cabin_in_the_cotton	the_cabin_in_the_cotton
hotel_haywire	hotel_haywire
behind_the_screen	behind_the_screen
until_they_sail	until_they_sail
cavaleiro_negro	cavaleiro_negro
love_is_a_racket	love_is_a_racket
little_women_(1949_film)	little_women_(1949_film)
fletch_(film)	fletch_(film)
the_shooter_(1995_film)	the_shooter_(1995_film)
walking_the_streets_of_moscow	walking_the_streets_of_moscow
manzilein_aur_bhi_hain	manzilein_aur_bhi_hain
the_yellow_balloon_(film)	the_yellow_balloon_(film)
adam's_wall	adam's_wall
the_terminal	the_terminal
one_night_husband	one_night_husband
hush_(1998_film)	hush_(1998_film)
la_folie_du_doute	la_folie_du_doute
charlie's_angels_(film)	charlie's_angels_(film)
sherrybaby	sherrybaby
love_story_2050	love_story_2050
the_lavender_hill_mob	the_lavender_hill_mob
kindergarten_cop	kindergarten_cop
apna_khoon	apna_khoon
children_of_pleasure	children_of_pleasure
captura_recomendada	captura_recomendada
jangal_mein_mangal	jangal_mein_mangal
the_scapegoat_(1959_film)	the_scapegoat_(1959_film)
caravan_(1934_film)	caravan_(1934_film)
high_road_to_china	high_road_to_china
jaadugar	jaadugar
rogue_(film)	rogue_(film)
in_the_name_of_the_father_(film)	in_the_name_of_the_father_(film)
the_interpreter	the_interpreter
harold_&_kumar_escape_from_guantanamo_bay	harold_&_kumar_escape_from_guantanamo_bay
seventh_heaven_(1937_film)	seventh_heaven_(1937_film)
in_old_chicago	in_old_chicago
shiki-jitsu	shiki-jitsu
white_palace_(film)	white_palace_(film)
kalloori_vaasal	kalloori_vaasal
yuva	yuva
yuva	aaytha_ezhuthu
for_love_or_money_(1993_film)	for_love_or_money_(1993_film)
agatha_(film)	agatha_(film)
a_woman	a_woman
alice,_sweet_alice	alice,_sweet_alice
the_true_story_of_jesse_james	the_true_story_of_jesse_james
sadgati	sadgati
stone_cold_(1991_film)	stone_cold_(1991_film)
ju_dou	ju_dou
the_wizard_of_oz_(1982_film)	the_wizard_of_oz_(1982_film)
hangmen_also_die!	hangmen_also_die!
bombay_(film)	bombay_(film)
uyarndhavargal	uyarndhavargal
americathon	americathon
springtime_in_a_small_town	springtime_in_a_small_town
seven_thieves	seven_thieves
sidewalks_of_london	sidewalks_of_london
bringing_out_the_dead	bringing_out_the_dead
critters_(film)	critters_(film)
lost_city_of_the_jungle	lost_city_of_the_jungle
head_office	head_office
pattanathil_bhootham	pattanathil_bhootham
the_lost_patrol_(1934_film)	the_lost_patrol_(1934_film)
the_stepford_wives_(1975_film)	the_stepford_wives_(1975_film)
saraband_for_dead_lovers	saraband_for_dead_lovers
i_like_you,_i_like_you_very_much	i_like_you,_i_like_you_very_much
the_general_died_at_dawn	the_general_died_at_dawn
blue_desert_(film)	blue_desert_(film)
blazing_the_overland_trail	blazing_the_overland_trail
hart's_war	hart's_war
goodbye_lover	goodbye_lover
diabolique_(1996_film)	diabolique_(1996_film)
next_time_we_love	next_time_we_love
reckless_(1984_film)	reckless_(1984_film)
iruvar	iruvar
small_change_(film)	small_change_(film)
the_giant_of_marathon	the_giant_of_marathon
alaipayuthey	alaipayuthey
the_beauty_jungle	the_beauty_jungle
summertime_(1955_film)	summertime_(1955_film)
siudo_ko_sindoor	siudo_ko_sindoor
do_risos_e_lagrimas	do_risos_e_lagrimas
you_must_be_joking!_(1965_film)	you_must_be_joking!_(1965_film)
go_(2007_film)	go_(2007_film)
hard_men	hard_men
street_knight	street_knight
river_queen	river_queen
el_juego_de_arcibel	el_juego_de_arcibel
the_courtneys_of_curzon_street	the_courtneys_of_curzon_street
we_live_again	we_live_again
aerial_anarchists	aerial_anarchists
chronicle_of_a_death_foretold_(film)	chronicle_of_a_death_foretold_(film)
cuore_di_cane	cuore_di_cane
trapped_in_a_purple_haze	trapped_in_a_purple_haze
jay_jay	jay_jay
see_no_evil_(1971_film)	see_no_evil_(1971_film)
lost_(1956_film)	lost_(1956_film)
my_name_is_khan	my_name_is_khan
call_me_bwana	call_me_bwana
forever,_lulu_(1987_film)	forever,_lulu_(1987_film)
shocker_(film)	shocker_(film)
here_come_the_munsters	here_come_the_munsters
riding_alone_for_thousands_of_miles	riding_alone_for_thousands_of_miles
the_white_sheik	the_white_sheik
honeymoon_in_bali	honeymoon_in_bali
oka_radha_iddaru_krishnulu	oka_radha_iddaru_krishnulu
the_tales_of_beatrix_potter	the_tales_of_beatrix_potter
time_out_(2001_film)	time_out_(2001_film)
the_legend_of_the_lone_ranger	the_legend_of_the_lone_ranger
saamy	saamy
the_overlanders_(film)	the_overlanders_(film)
blue_puppy	blue_puppy
windows_(film)	windows_(film)
der_choral_von_leuthen	der_choral_von_leuthen
mein_ek_din_laut_kay_aaoon_ga	mein_ek_din_laut_kay_aaoon_ga
hameshaa	hameshaa
55_days_at_peking	55_days_at_peking
phool_aur_patthar	phool_aur_patthar
seeta_aur_geeta	seeta_aur_geeta
open_from_18_to_24	open_from_18_to_24
week_ends_only	week_ends_only
nee_venunda_chellam	nee_venunda_chellam
the_whisperers	the_whisperers
the_black_rose	the_black_rose
operation_concrete	operation_concrete
veronika_voss	veronika_voss
vatsalyam	vatsalyam
mother,_jugs_&_speed	mother,_jugs_&_speed
a_soldier's_tale	a_soldier's_tale
saathiya_(film)	saathiya_(film)
yeh_lamhe_judaai_ke	yeh_lamhe_judaai_ke
vijetha	vijetha
kaalia	kaalia
enga_veettu_pillai	enga_veettu_pillai
prema_pusthakam	prema_pusthakam
one_stone_two_birds	one_stone_two_birds
into_the_west_(film)	into_the_west_(film)
buscando_a_miguel	buscando_a_miguel
chaahat_(1996_film)	chaahat_(1996_film)
dances_with_wolves	dances_with_wolves
the_taking_of_pelham_one_two_three_(1974_film)	the_taking_of_pelham_one_two_three_(1974_film)
pratibandh	pratibandh
the_accidental_husband	the_accidental_husband
anna_to_the_infinite_power	anna_to_the_infinite_power
kanto_wanderer	kanto_wanderer
dastak	dastak
be_here_to_love_me	be_here_to_love_me
the_day_will_dawn	the_day_will_dawn
carousel_(film)	carousel_(film)
bachpan	bachpan
lady_in_the_fog	lady_in_the_fog
atlantic_(film)	atlantic_(film)
never_forever	never_forever
yellowbeard	yellowbeard
buddha_mar_gaya	buddha_mar_gaya
our_dancing_daughters	our_dancing_daughters
pretty_in_pink	pretty_in_pink
tears_of_the_sun	tears_of_the_sun
sink_the_bismarck!	sink_the_bismarck!
city_of_women	city_of_women
the_vampire_lovers	the_vampire_lovers
web_of_the_spider	web_of_the_spider
say_salaam_india	say_salaam_india
the_final_countdown_(film)	the_final_countdown_(film)
the_tales_of_hoffmann_(film)	the_tales_of_hoffmann_(film)
thakshak	thakshak
duma_(film)	duma_(film)
tokyo_twilight	tokyo_twilight
shool	shool
sometimes_in_april	sometimes_in_april
brainscan	brainscan
chachi_420	chachi_420
the_house_across_the_lake	the_house_across_the_lake
auggie_rose	auggie_rose
sleeping_beauties	sleeping_beauties
the_hidden_fortress	the_hidden_fortress
gente_di_roma	gente_di_roma
my_brother_jonathan	my_brother_jonathan
mukhbiir	mukhbiir
torch_song_(1993_film)	torch_song_(1993_film)
my_blue_heaven_(1990_film)	my_blue_heaven_(1990_film)
too_late_the_hero_(film)	too_late_the_hero_(film)
chalti_ka_naam_gaadi	chalti_ka_naam_gaadi
dus_numbri	dus_numbri
love_is_strength	love_is_strength
588_rue_paradis	588_rue_paradis
pran_jaye_par_shaan_na_jaye	pran_jaye_par_shaan_na_jaye
ibu_mertuaku	ibu_mertuaku
the_princess_comes_across	the_princess_comes_across
fabiola_(1949_film)	fabiola_(1949_film)
periyanna	periyanna
arrabalera	arrabalera
diving_in	diving_in
grosse_pointe_blank	grosse_pointe_blank
pattiyal	pattiyal
stay_tuned_(film)	stay_tuned_(film)
cruel_intentions_2	cruel_intentions_2
andaz_(1994_film)	andaz_(1994_film)
the_fifth_missile	the_fifth_missile
the_citadel_(film)	the_citadel_(film)
coma_(1978_film)	coma_(1978_film)
a_dry_white_season	a_dry_white_season
riders_to_the_stars	riders_to_the_stars
amara_prema	amara_prema
thoongadhey_thambi_thoongadhey	thoongadhey_thambi_thoongadhey
the_hidden_blade	the_hidden_blade
port_of_shadows	port_of_shadows
macon_county_line	macon_county_line
the_attack_of_the_giant_moussaka	the_attack_of_the_giant_moussaka
twilight_(1998_film)	twilight_(1998_film)
i_as_in_icarus	i_as_in_icarus
another_man's_poison	another_man's_poison
a_touch_of_class_(film)	a_touch_of_class_(film)
phool_bane_angaray	phool_bane_angaray
dil_se..	dil_se..
big_fella	big_fella
ara_soyza	ara_soyza
queen_of_the_damned	queen_of_the_damned
something_always_happens	something_always_happens
vetri_kodi_kattu	vetri_kodi_kattu
la_roue	la_roue
the_mighty_quinn_(film)	the_mighty_quinn_(film)
manithan	manithan
long_john_silver_(film)	long_john_silver_(film)
seda_sulang	seda_sulang
unnai_suttrum_ulagam	unnai_suttrum_ulagam
dachimawa_lee	dachimawa_lee
the_feather_fairy	the_feather_fairy
main_tulsi_tere_aangan_ki	main_tulsi_tere_aangan_ki
the_mummy_(1959_film)	the_mummy_(1959_film)
sakhiya	sakhiya
love_affair_(1994_film)	love_affair_(1994_film)
kiss_me_kate_(film)	kiss_me_kate_(film)
the_execution_of_mary_stuart	the_execution_of_mary_stuart
jana_aranya	jana_aranya
aacharya	aacharya
the_gold_of_naples	the_gold_of_naples
city_of_ember	city_of_ember
six_days_seven_nights	six_days_seven_nights
a_hole_in_the_head	a_hole_in_the_head
away_all_boats	away_all_boats
after_shave_(1999_film)	after_shave_(1999_film)
sea_of_love_(film)	sea_of_love_(film)
shrek_the_third	shrek_the_third
footloose_(1984_film)	footloose_(1984_film)
ratboy	ratboy
intacto	intacto
king_of_the_congo	king_of_the_congo
madadayo	madadayo
indira_(film)	indira_(film)
the_seventh_veil	the_seventh_veil
split_wide_open	split_wide_open
rainbow_(2005_film)	rainbow_(2005_film)
american_pie_2	american_pie_2
hey,_hey,_it's_esther_blueburger	hey,_hey,_it's_esther_blueburger
the_adventure_of_faustus_bidgood	the_adventure_of_faustus_bidgood
sagara_sangamam	sagara_sangamam
confessions_of_a_window_cleaner	confessions_of_a_window_cleaner
please_teach_me_english	please_teach_me_english
ten_canoes	ten_canoes
the_innocent_(1993_film)	the_innocent_(1993_film)
blithe_spirit_(film)	blithe_spirit_(film)
my_little_chickadee	my_little_chickadee
monsieur_vincent	monsieur_vincent
pagadai_panirendu	pagadai_panirendu
la_prima_notte_di_quiete	la_prima_notte_di_quiete
the_appointment	the_appointment
silk_stockings_(film)	silk_stockings_(film)
project_moonbase	project_moonbase
any_gun_can_play	any_gun_can_play
panienka_z_poste_restante	panienka_z_poste_restante
big_ears	big_ears
ponette	ponette
aurat_aurat_aurat	aurat_aurat_aurat
spookies	spookies
outbreak_(film)	outbreak_(film)
the_young_doctors_(film)	the_young_doctors_(film)
drowning_by_numbers	drowning_by_numbers
barsaat_(1949_film)	barsaat_(1949_film)
home_of_the_brave_(1949_film)	home_of_the_brave_(1949_film)
the_other_end_of_the_line	the_other_end_of_the_line
doc_(film)	doc_(film)
paulie	paulie
mere_yaar_ki_shaadi_hai	mere_yaar_ki_shaadi_hai
scream_2	scream_2
a_degree_of_murder	a_degree_of_murder
the_big_red_one	the_big_red_one
arabian_nights_(1974_film)	arabian_nights_(1974_film)
courage_under_fire	courage_under_fire
four_flies_on_grey_velvet	four_flies_on_grey_velvet
ayat-ayat_cinta	ayat-ayat_cinta
chor_machaaye_shor	chor_machaaye_shor
precautions_against_fanatics	precautions_against_fanatics
with_the_music_in_my_soul	with_the_music_in_my_soul
husband_for_hire	husband_for_hire
smart_people	smart_people
48_hours_of_hallucinatory_sex	48_hours_of_hallucinatory_sex
do_bigha_zamin	do_bigha_zamin
hidalgo_(film)	hidalgo_(film)
the_mosquito_coast	the_mosquito_coast
the_haunted_strangler	the_haunted_strangler
the_extraordinary_adventures_of_mr._west_in_the_land_of_the_bolsheviks	the_extraordinary_adventures_of_mr._west_in_the_land_of_the_bolsheviks
mumbai_express	mumbai_express
mumbai_express	mumbai_xpress
waiter!	waiter!
uruvangal_maralam	uruvangal_maralam
see_spot_run	see_spot_run
the_truth_about_spring	the_truth_about_spring
the_three_stooges_collection	the_three_stooges_collection
mera_saaya	mera_saaya
love_among_the_ruins_(film)	love_among_the_ruins_(film)
as_you_like_it_(1936_film)	as_you_like_it_(1936_film)
nuvve_nuvve	nuvve_nuvve
maxed_out	maxed_out
the_way_to_the_stars	the_way_to_the_stars
charley's_(big-hearted)_aunt	charley's_(big-hearted)_aunt
mourning_becomes_electra_(film)	mourning_becomes_electra_(film)
moscow_strikes_back	moscow_strikes_back
the_boys_in_company_c	the_boys_in_company_c
to_the_devil_a_daughter	to_the_devil_a_daughter
quitting	quitting
bunty_aur_babli	bunty_aur_babli
nilaave_vaa	nilaave_vaa
twice_upon_a_time_(1953_film)	twice_upon_a_time_(1953_film)
anne_of_green_gables_(1934_film)	anne_of_green_gables_(1934_film)
ghostbusters_ii	ghostbusters_ii
doodeind	doodeind
picture_claire	picture_claire
cage_without_a_key	cage_without_a_key
mr._blandings_builds_his_dream_house	mr._blandings_builds_his_dream_house
the_last_of_mrs._cheyney_(1937_film)	the_last_of_mrs._cheyney_(1937_film)
dias_contados	dias_contados
flicka	flicka
national_treasure_(film)	national_treasure_(film)
fatal_attraction	fatal_attraction
sucker_free_city	sucker_free_city
the_big_fisherman	the_big_fisherman
man_in_the_middle_(film)	man_in_the_middle_(film)
the_story_of_esther_costello	the_story_of_esther_costello
little_nikita	little_nikita
the_nanny_(1965_film)	the_nanny_(1965_film)
the_color_of_paradise	the_color_of_paradise
temptation_harbour	temptation_harbour
the_french_lieutenant's_woman_(film)	the_french_lieutenant's_woman_(film)
bird_(film)	bird_(film)
rappin'	rappin'
immaan_dharam	immaan_dharam
the_lost_planet	the_lost_planet
motel_hell	motel_hell
auzaar	auzaar
balu_abcdefg	balu_abcdefg
nishchaiy	nishchaiy
journey_for_margaret	journey_for_margaret
ambassador_bill	ambassador_bill
night_at_the_crossroads	night_at_the_crossroads
aag_hi_aag	aag_hi_aag
if_only_(film)	if_only_(film)
seval	seval
bloodlust!	bloodlust!
the_spirit_of_'76_(1990_film)	the_spirit_of_'76_(1990_film)
monsignor_(film)	monsignor_(film)
hell_is_a_city	hell_is_a_city
tea_with_mussolini	tea_with_mussolini
singaravelan	singaravelan
honkytonk_man	honkytonk_man
aag_ke_sholay	aag_ke_sholay
bongoland	bongoland
cobra_verde	cobra_verde
pithamagan	pithamagan
minnale	minnale
the_marrying_man	the_marrying_man
shinsukki_blues	shinsukki_blues
beginner's_luck	beginner's_luck
video_from_hell	video_from_hell
semi-pro	semi-pro
vrutham	vrutham
young_breasts	young_breasts
god's_angry_man	god's_angry_man
a_good_year	a_good_year
critters_3	critters_3
old_gringo	old_gringo
jaane_bhi_do_yaaro	jaane_bhi_do_yaaro
camille_(1936_film)	camille_(1936_film)
criminal_(2004_film)	criminal_(2004_film)
karlas_kabale	karlas_kabale
bianco,_rosso_e_verdone	bianco,_rosso_e_verdone
a_change_of_seasons_(film)	a_change_of_seasons_(film)
my_life_in_ruins	my_life_in_ruins
the_killing_phone	the_killing_phone
laser_mission	laser_mission
captains_of_the_clouds	captains_of_the_clouds
erik_the_conqueror	erik_the_conqueror
as_young_as_you_feel	as_young_as_you_feel
flying_high_(1931_film)	flying_high_(1931_film)
ro.go.pa.g.	ro.go.pa.g.
that_night_in_varennes	that_night_in_varennes
moonlight_mile_(film)	moonlight_mile_(film)
inferno_(1980_film)	inferno_(1980_film)
another_thin_man	another_thin_man
heroic_duo	heroic_duo
ruggles_of_red_gap	ruggles_of_red_gap
mulholland_falls	mulholland_falls
real_women_have_curves	real_women_have_curves
om_jai_jagadish	om_jai_jagadish
carlton-browne_of_the_f.o.	carlton-browne_of_the_f.o.
black_rain_(1989_japanese_film)	black_rain_(1989_japanese_film)
the_love_test	the_love_test
the_atomic_city	the_atomic_city
dead_of_night	dead_of_night
feast_of_love	feast_of_love
the_man_from_dakota	the_man_from_dakota
jibon_theke_neya	jibon_theke_neya
the_roller_blade_seven	the_roller_blade_seven
american_yearbook	american_yearbook
barbarosa	barbarosa
being_julia	being_julia
alan_&_naomi	alan_&_naomi
runaway_(1984_film)	runaway_(1984_film)
snow_day_(film)	snow_day_(film)
suspicious_river	suspicious_river
the_moonraker	the_moonraker
to_kill_with_intrigue	to_kill_with_intrigue
mastan	mastan
flightplan	flightplan
eversmile,_new_jersey	eversmile,_new_jersey
the_house_by_the_cemetery	the_house_by_the_cemetery
dead_men_don't_wear_plaid	dead_men_don't_wear_plaid
enter_the_ninja	enter_the_ninja
in_old_arizona	in_old_arizona
cell_phone_(film)	cell_phone_(film)
i_am_a_fugitive_from_a_chain_gang	i_am_a_fugitive_from_a_chain_gang
naam_(1986_film)	naam_(1986_film)
gopi_kishan	gopi_kishan
yol	yol
the_song_of_sparrows	the_song_of_sparrows
disco_pigs	disco_pigs
jai_chiranjeeva	jai_chiranjeeva
bintou	bintou
joshila	joshila
i.q._(film)	i.q._(film)
the_gold_rimmed_glasses	the_gold_rimmed_glasses
konchem_koththaga	konchem_koththaga
and_you_thought_your_parents_were_weird	and_you_thought_your_parents_were_weird
it_happens_every_spring	it_happens_every_spring
death_becomes_her	death_becomes_her
the_lucky_guy	the_lucky_guy
kithakithalu	kithakithalu
the_young_mr_pitt	the_young_mr_pitt
don't_touch_the_white_woman!	don't_touch_the_white_woman!
the_clique_(film)	the_clique_(film)
thun_man_handiya	thun_man_handiya
the_marseille_contract	the_marseille_contract
son_of_sinbad	son_of_sinbad
the_red_tent_(film)	the_red_tent_(film)
arrival_of_tongkin_train	arrival_of_tongkin_train
the_man_who_knew_too_much_(1956_film)	the_man_who_knew_too_much_(1956_film)
the_chinese_feast	the_chinese_feast
glory_road_(film)	glory_road_(film)
sasanam	sasanam
roman_holiday	roman_holiday
le_clan_des_siciliens	le_clan_des_siciliens
outland_(film)	outland_(film)
challenge_to_lassie	challenge_to_lassie
bombay_to_goa	bombay_to_goa
under_the_roofs_of_paris	under_the_roofs_of_paris
francesco_(film)	francesco_(film)
agent_x44	agent_x44
everybody's_fine_(1990_film)	everybody's_fine_(1990_film)
playing_with_death	playing_with_death
voyage_of_the_unicorn	voyage_of_the_unicorn
the_driver's_seat_(film)	the_driver's_seat_(film)
paapi	paapi
faraar	faraar
in_the_name_of_the_pope_king	in_the_name_of_the_pope_king
article_47,_l'	article_47,_l'
main_sunder_hoon	main_sunder_hoon
derailed_(2005_film)	derailed_(2005_film)
the_great_gatsby_(1949_film)	the_great_gatsby_(1949_film)
lloyd's_of_london_(film)	lloyd's_of_london_(film)
beau_hunks	beau_hunks
janam	janam
in_the_realm_of_the_senses	in_the_realm_of_the_senses
bulldog_drummond_strikes_back	bulldog_drummond_strikes_back
a_way_of_life	a_way_of_life
you'll_never_get_rich	you'll_never_get_rich
rage_of_honor	rage_of_honor
deewane_huye_paagal	deewane_huye_paagal
three_men_on_a_horse_(film)	three_men_on_a_horse_(film)
preetam	preetam
mighty_joe_young_(1998_film)	mighty_joe_young_(1998_film)
manhattan_parade	manhattan_parade
mehndi_waley_hath	mehndi_waley_hath
the_man_who_never_was	the_man_who_never_was
vaanmathi	vaanmathi
the_beast_with_five_fingers	the_beast_with_five_fingers
in_country	in_country
explorers_(film)	explorers_(film)
feeding_sea_lions	feeding_sea_lions
tapeheads	tapeheads
muqaddar_ka_sikandar	muqaddar_ka_sikandar
the_dust_factory	the_dust_factory
parzania	parzania
the_hidan_of_maukbeiangjow	the_hidan_of_maukbeiangjow
maha-sangram	maha-sangram
my_father_is_a_hero	my_father_is_a_hero
failure_to_launch	failure_to_launch
angel_heart	angel_heart
the_naked_jungle	the_naked_jungle
simone_(2002_film)	simone_(2002_film)
the_taste_of_tea	the_taste_of_tea
anjaam	anjaam
the_girl_who_knew_too_much_(1963_film)	the_girl_who_knew_too_much_(1963_film)
the_buddy_holly_story	the_buddy_holly_story
the_pumpkin_eater	the_pumpkin_eater
amarcord	amarcord
blinky_bill_(film)	blinky_bill_(film)
majajan	majajan
thx_1138	thx_1138
the_quiller_memorandum	the_quiller_memorandum
get_yourself_a_college_girl	get_yourself_a_college_girl
las_aventuras_de_tremendo	las_aventuras_de_tremendo
beder_meye_josna	beder_meye_josna
beethoven's_4th	beethoven's_4th
busting	busting
addicted_to_love_(film)	addicted_to_love_(film)
how_much_wood_would_a_woodchuck_chuck_(film)	how_much_wood_would_a_woodchuck_chuck_(film)
the_misadventures_of_merlin_jones	the_misadventures_of_merlin_jones
aankhen_(2002_film)	aankhen_(2002_film)
s._p._parasuram	s._p._parasuram
to_brave_alaska	to_brave_alaska
badnaam	badnaam
une_hirondelle_a_fait_le_printemps	une_hirondelle_a_fait_le_printemps
akkara_paha	akkara_paha
hedgehog_in_the_fog	hedgehog_in_the_fog
caravaggio_(1986_film)	caravaggio_(1986_film)
now_you_see_him,_now_you_don't	now_you_see_him,_now_you_don't
mee_sreyobhilashi	mee_sreyobhilashi
strictly_dishonorable_(1931_film)	strictly_dishonorable_(1931_film)
pather_panchali	pather_panchali
al-tareeq_al-masdood	al-tareeq_al-masdood
bal_bramhachari	bal_bramhachari
the_drum_(1938_film)	the_drum_(1938_film)
sollathaan_ninaikkiren	sollathaan_ninaikkiren
blaumilch_canal	blaumilch_canal
ipolochagos_natassa	ipolochagos_natassa
by_touch	by_touch
bade_dil_wala	bade_dil_wala
the_adding_machine_(film)	the_adding_machine_(film)
love_me,_love_my_money	love_me,_love_my_money
under_capricorn	under_capricorn
jagte_raho	jagte_raho
banaras_(2006_film)	banaras_(2006_film)
zhou_yu's_train	zhou_yu's_train
a_stolen_life_(1946_film)	a_stolen_life_(1946_film)
candy_(2006_film)	candy_(2006_film)
the_oil_gush_fire_in_bibiheybat	the_oil_gush_fire_in_bibiheybat
rowdy_alludu	rowdy_alludu
miss_pettigrew_lives_for_a_day	miss_pettigrew_lives_for_a_day
chathikkatha_chanthu	chathikkatha_chanthu
cool_hand_luke	cool_hand_luke
broken_arrow_(1950_film)	broken_arrow_(1950_film)
letters_from_iwo_jima	letters_from_iwo_jima
pakeezah	pakeezah
black_mask_(film)	black_mask_(film)
finger_prints_(serial)	finger_prints_(serial)
head_above_water	head_above_water
the_little_devil	the_little_devil
the_best_man_(1964_film)	the_best_man_(1964_film)
love_me_or_leave_me_(film)	love_me_or_leave_me_(film)
can_this_be_love	can_this_be_love
grahan	grahan
a_woman_called_moses	a_woman_called_moses
saathi	saathi
a_prayer_for_the_dying	a_prayer_for_the_dying
piccadilly_third_stop	piccadilly_third_stop
bees_in_paradise	bees_in_paradise
house_of_himiko	house_of_himiko
swingers_(1996_film)	swingers_(1996_film)
strictly_dishonorable_(1951_film)	strictly_dishonorable_(1951_film)
whispering_corridors_(film_series)	whispering_corridors
bram_stoker's_dracula's_curse	bram_stoker's_dracula's_curse
no_reservations_(film)	no_reservations_(film)
drunken_angel	drunken_angel
bloodstone_(1988_film)	bloodstone_(1988_film)
daniel_(film)	daniel_(film)
the_positively_true_adventures_of_the_alleged_texas_cheerleader-murdering_mom	the_positively_true_adventures_of_the_alleged_texas_cheerleader-murdering_mom
king_of_kings_(1961_film)	king_of_kings_(1961_film)
the_black_cat_(1941_film)	the_black_cat_(1941_film)
rosy_dreams	rosy_dreams
valiant_is_the_word_for_carrie	valiant_is_the_word_for_carrie
oath_of_vengeance	oath_of_vengeance
the_long_duel	the_long_duel
dr._t_&_the_women	dr._t_&_the_women
rendu_jella_sita	rendu_jella_sita
the_draughtsman's_contract	the_draughtsman's_contract
the_living_desert	the_living_desert
burglar_(film)	burglar_(film)
modern_girls	modern_girls
the_night_they_raided_minsky's	the_night_they_raided_minsky's
scenes_from_a_mall	scenes_from_a_mall
baladur	baladur
barsaat_ki_ek_raat	barsaat_ki_ek_raat
des_teufels_general	des_teufels_general
fathom_(film)	fathom_(film)
flight_to_fury	flight_to_fury
the_navigators_(film)	the_navigators_(film)
cruza	cruza
thunder_birds_(1942_film)	thunder_birds_(1942_film)
bucking_broadway	bucking_broadway
life_at_the_top_(film)	life_at_the_top_(film)
the_ghost_goes_west	the_ghost_goes_west
a_taxing_woman	a_taxing_woman
the_inner_eye	the_inner_eye
lord_byron_of_broadway	lord_byron_of_broadway
it's_trad,_dad!	it's_trad,_dad!
i'm_no_angel	i'm_no_angel
two_thousand_maniacs!	two_thousand_maniacs!
aliens_in_the_attic	aliens_in_the_attic
the_haunted_house_of_horror	the_haunted_house_of_horror
maker_of_men	maker_of_men
billy_budd_(film)	billy_budd_(film)
body_heat	body_heat
3_needles	3_needles
survival_island	survival_island
lord_of_war	lord_of_war
the_edge_(1997_film)	the_edge_(1997_film)
adarawanthayo	adarawanthayo
vaasthavam	vaasthavam
the_children_of_the_marshland	the_children_of_the_marshland
chellamae	chellamae
andarivaadu	andarivaadu
tata_birla_madhyalo_laila	tata_birla_madhyalo_laila
def-con_4	def-con_4
the_testament_of_dr._mabuse	the_testament_of_dr._mabuse
flesh_color	flesh_color
a_night_in_the_show	a_night_in_the_show
same_time,_next_year_(film)	same_time,_next_year_(film)
real_men_(film)	real_men_(film)
that_riviera_touch	that_riviera_touch
ram_balram	ram_balram
when_i_fall_in_love..._with_both	when_i_fall_in_love..._with_both
godforsaken	godforsaken
when_love_begins	when_love_begins
hang_'em_high	hang_'em_high
breakfast_with_scot	breakfast_with_scot
bubble_boy_(film)	bubble_boy_(film)
l.a._story	l.a._story
davy_crockett,_king_of_the_wild_frontier	davy_crockett,_king_of_the_wild_frontier
further_up_the_creek	further_up_the_creek
to_sleep_with_anger	to_sleep_with_anger
center_stage_(2000_film)	center_stage_(2000_film)
trog	trog
painkiller_jane_(film)	painkiller_jane_(film)
oedipus_rex_(film)	oedipus_rex_(film)
lost_embrace	lost_embrace
tribute_to_a_bad_man	tribute_to_a_bad_man
devi_(1960_film)	devi_(1960_film)
permanent_midnight	permanent_midnight
under_fire_(film)	under_fire_(film)
cruising_(film)	cruising_(film)
per_sollum_pillai	per_sollum_pillai
night_of_the_seagulls	night_of_the_seagulls
monster_in_the_closet	monster_in_the_closet
lolita_(1997_film)	lolita_(1997_film)
paano_kita_iibigin	paano_kita_iibigin
el_perro	el_perro
amma_cheppindi	amma_cheppindi
kadhal_azhivathillai	kadhal_azhivathillai
holiday_hotel	holiday_hotel
lake_dead	lake_dead
the_ring_(2002_film)	the_ring_(2002_film)
love_letter_(1995_film)	love_letter_(1995_film)
the_mystery_squadron	the_mystery_squadron
honeysuckle_rose_(film)	honeysuckle_rose_(film)
the_baby-sitters_club_(film)	the_baby-sitters_club_(film)
a_doll's_house_(1973_losey_film)	a_doll's_house_(1973_losey_film)
the_two_faces_of_dr._jekyll	the_two_faces_of_dr._jekyll
once_upon_a_time_in_high_school	once_upon_a_time_in_high_school
killer_meteors	killer_meteors
army_of_shadows	army_of_shadows
morning_light	morning_light
un_rey_en_la_habana	un_rey_en_la_habana
drifting_clouds_(film)	drifting_clouds_(film)
kalteva_torni	kalteva_torni
taj_mahal_(1999_film)	taj_mahal_(1999_film)
the_musketeer	the_musketeer
the_thirteenth_floor	the_thirteenth_floor
hawaii,_oslo	hawaii,_oslo
la_stanza_del_vescovo_(film)	la_stanza_del_vescovo_(film)
breast_men	breast_men
the_nun_(1966_film)	the_nun_(1966_film)
balwaan	balwaan
damaged_lives	damaged_lives
griha_pravesh	griha_pravesh
wagon_master	wagon_master
dr._terror's_house_of_horrors	dr._terror's_house_of_horrors
rock_on!!	rock_on!!
ullasamga_utsahamga	ullasamga_utsahamga
julie_ganapathi	julie_ganapathi
kadamai_kanniyam_kattupaadu	kadamai_kanniyam_kattupaadu
departamento_compartido	departamento_compartido
cameriera_bella_presenza_offresi...	cameriera_bella_presenza_offresi...
the_big_circus	the_big_circus
mafioso_(film)	mafioso_(film)
phil_the_alien	phil_the_alien
clancy_of_the_mounted	clancy_of_the_mounted
madonna_of_the_seven_moons	madonna_of_the_seven_moons
boxing_in_barrels	boxing_in_barrels
whoopee!_(film)	whoopee!_(film)
they_won't_forget	they_won't_forget
andhra_kesari	andhra_kesari
fanatic_(film)	fanatic_(film)
andy_hardy's_private_secretary	andy_hardy's_private_secretary
austeria	austeria
the_offence	the_offence
just_another_saturday	just_another_saturday
firstborn_(film)	firstborn_(film)
pyaasa_sawan	pyaasa_sawan
keep_'em_flying	keep_'em_flying
quigley_down_under	quigley_down_under
pardon_mon_affaire,_too!	pardon_mon_affaire,_too!
blind_shaft	blind_shaft
robocop_2	robocop_2
ghost_dad	ghost_dad
the_contract_(2006_film)	the_contract_(2006_film)
ram_jaane	ram_jaane
the_twin_(film)	the_twin_(film)
men_with_guns	men_with_guns
radio_bar	radio_bar
wet_dreams_2	wet_dreams_2
bandolero!	bandolero!
x_the_unknown	x_the_unknown
we,_the_women	we,_the_women
sirens_(1994_film)	sirens_(1994_film)
seed_(1931_film)	seed_(1931_film)
kadhalar_dhinam	kadhalar_dhinam
yeh_teraa_ghar_yeh_meraa_ghar	yeh_teraa_ghar_yeh_meraa_ghar
don't_raise_the_bridge,_lower_the_river	don't_raise_the_bridge,_lower_the_river
200_motels	200_motels
kumaara_vijayam	kumaara_vijayam
canadian_bacon	canadian_bacon
from_the_life_of_the_marionettes	from_the_life_of_the_marionettes
diamond_jim	diamond_jim
there_will_be_no_leave_today	there_will_be_no_leave_today
vikramarkudu	vikramarkudu
h.m.s._defiant	h.m.s._defiant
andhrudu	andhrudu
the_ex_(1997_film)	the_ex_(1997_film)
aram_(2002_film)	aram_(2002_film)
door_on_the_left_as_you_leave_the_elevator	door_on_the_left_as_you_leave_the_elevator
subconscious_cruelty	subconscious_cruelty
arinthum_ariyamalum	arinthum_ariyamalum
le_amiche	le_amiche
sostiene_pereira	sostiene_pereira
last_action_hero	last_action_hero
aan_milo_sajna	aan_milo_sajna
yousuf_khan_sher_bano	yousuf_khan_sher_bano
el_andador	el_andador
outcast_of_the_islands	outcast_of_the_islands
a_carol_for_another_christmas	a_carol_for_another_christmas
rekava	rekava
detroit_rock_city_(film)	detroit_rock_city_(film)
yuddho	yuddho
a_driver_for_vera	a_driver_for_vera
head_against_the_wall	head_against_the_wall
uthiripookkal	uthiripookkal
the_night_porter	the_night_porter
princess_yang_kwei-fei	princess_yang_kwei-fei
the_quiet_man	the_quiet_man
ostatnia_brygada	ostatnia_brygada
revenge_of_the_creature	revenge_of_the_creature
faraway,_so_close!	faraway,_so_close!
moondru_mugam	moondru_mugam
the_changeling_(1980_film)	the_changeling_(1980_film)
open_doors_(film)	open_doors_(film)
parash_pathar	parash_pathar
the_pick-up_artist_(film)	the_pick-up_artist_(film)
used_cars	used_cars
chaplin_(film)	chaplin_(film)
away_with_words	away_with_words
breach_(film)	breach_(film)
the_return_of_doctor_x	the_return_of_doctor_x
pagaivan	pagaivan
waiting_for_the_messiah	waiting_for_the_messiah
vento_del_sud	vento_del_sud
coach_carter	coach_carter
beast_cops	beast_cops
lamerica	lamerica
bonzo_goes_to_college	bonzo_goes_to_college
naam_pirandha_mann	naam_pirandha_mann
adaptatziya	adaptatziya
wrestling_ernest_hemingway	wrestling_ernest_hemingway
yentl_(film)	yentl_(film)
bridge_to_the_sun	bridge_to_the_sun
hard_rain_(film)	hard_rain_(film)
troubled_water	troubled_water
let_it_ride_(film)	let_it_ride_(film)
shoulder_arms	shoulder_arms
les_vampires	les_vampires
l'auberge_espagnole	l'auberge_espagnole
book_of_dragons	book_of_dragons
the_return_of_captain_nemo	the_return_of_captain_nemo
waist_deep	waist_deep
beat_the_drum	beat_the_drum
the_stolen_children	the_stolen_children
oxford_blues	oxford_blues
pump_up_the_volume_(film)	pump_up_the_volume_(film)
maidan-e-jung	maidan-e-jung
most_wanted_(1997_film)	most_wanted_(1997_film)
elephant_boy_(film)	elephant_boy_(film)
jet_storm	jet_storm
not_without_my_daughter	not_without_my_daughter
yojimbo_(film)	yojimbo_(film)
beneath_the_12-mile_reef	beneath_the_12-mile_reef
the_ambushers_(film)	the_ambushers_(film)
lemony_snicket's_a_series_of_unfortunate_events	lemony_snicket's_a_series_of_unfortunate_events
broken_arrow_(1996_film)	broken_arrow_(1996_film)
cadillac_man	cadillac_man
pehla_pehla_pyaar	pehla_pehla_pyaar
personal_best_(film)	personal_best_(film)
underworld_beauty	underworld_beauty
the_rogue_song	the_rogue_song
son_of_frankenstein	son_of_frankenstein
winky's_horse	winky's_horse
ferris_bueller's_day_off	ferris_bueller's_day_off
no_love_for_johnnie	no_love_for_johnnie
absender_unbekannt	absender_unbekannt
a_nightmare_on_elm_street	a_nightmare_on_elm_street
revive!_ultraman	revive!_ultraman
oru_oodhappu_kan_simittugiradhu	oru_oodhappu_kan_simittugiradhu
tatie_danielle	tatie_danielle
black_orpheus	black_orpheus
agar_tum_na_hote	agar_tum_na_hote
we_dive_at_dawn	we_dive_at_dawn
aan	aan
the_flying_saucer	the_flying_saucer
kondaveeti_donga	kondaveeti_donga
balada_para_un_mochilero	balada_para_un_mochilero
ajooba	ajooba
aandhi	aandhi
amen.	amen.
zangezur_(film)	zangezur_(film)
la_commare_secca	la_commare_secca
an_affair_of_honor	an_affair_of_honor
brokedown_palace	brokedown_palace
wild_search	wild_search
journey_to_italy	journey_to_italy
'til_we_meet_again	'til_we_meet_again
shooter_(2007_film)	shooter_(2007_film)
city_by_the_sea	city_by_the_sea
untold_scandal	untold_scandal
the_nativity_story	the_nativity_story
spiritual_kung_fu	spiritual_kung_fu
the_simpsons_movie	the_simpsons_movie
u_turn_(1997_film)	u_turn_(1997_film)
kattradhu_thamizh	kattradhu_thamizh
the_record_of_a_tenement_gentleman	the_record_of_a_tenement_gentleman
dark_command	dark_command
benny_&_joon	benny_&_joon
the_adventures_of_elmo_in_grouchland	the_adventures_of_elmo_in_grouchland
lilies_(film)	lilies_(film)
cheyenne_autumn	cheyenne_autumn
i_passed_for_white	i_passed_for_white
the_monkey's_mask	the_monkey's_mask
the_nine_lives_of_fritz_the_cat	the_nine_lives_of_fritz_the_cat
savage_nights	savage_nights
blissfully_yours	blissfully_yours
merry_christmas,_mr._lawrence	merry_christmas,_mr._lawrence
the_naked_maja	the_naked_maja
thalai_nagaram	thalai_nagaram
good_morning,_night	good_morning,_night
cavalcade_of_heroes	cavalcade_of_heroes
maine_dil_tujhko_diya	maine_dil_tujhko_diya
the_little_minister	the_little_minister
sone_yay	sone_yay
looking_for_comedy_in_the_muslim_world	looking_for_comedy_in_the_muslim_world
kele_handa	kele_handa
fire_birds	fire_birds
dr._dolittle_(film)	dr._dolittle_(film)
soggadu_(2005_film)	soggadu_(2005_film)
una_jaula_no_tiene_secretos	una_jaula_no_tiene_secretos
kaala_patthar	kaala_patthar
arvind_desai_ki_ajeeb_dastaan	arvind_desai_ki_ajeeb_dastaan
beverly_hills_cop_(franchise)	beverly_hills_cop_ii
beverly_hills_cop_(franchise)	beverly_hills_cop
beverly_hills_cop_(franchise)	beverly_hills_cop_(franchise)
the_ninth_day	the_ninth_day
the_master_of_ballantrae_(film)	the_master_of_ballantrae_(film)
tagget	tagget
almost_normal	almost_normal
all_about_hash	all_about_hash
date_movie	date_movie
the_greatest_game_ever_played	the_greatest_game_ever_played
bride_of_frankenstein	bride_of_frankenstein
ek_chadar_maili_si	ek_chadar_maili_si
eulogy_(film)	eulogy_(film)
thedi_vandha_mappillai	thedi_vandha_mappillai
midnight_run	midnight_run
born_to_be_wild_(1995_film)	born_to_be_wild_(1995_film)
o_fantasma	o_fantasma
tarnation_(film)	tarnation_(film)
past_midnight	past_midnight
the_tenth_level	the_tenth_level
dancer_(1991_film)	dancer_(1991_film)
the_captain_hates_the_sea	the_captain_hates_the_sea
sivappathigaram	sivappathigaram
tujhe_meri_kasam	tujhe_meri_kasam
fools_of_fortune	fools_of_fortune
the_beast_from_20,000_fathoms	the_beast_from_20,000_fathoms
cry_freedom	cry_freedom
ditte,_child_of_man	ditte,_child_of_man
in_the_land_of_the_head_hunters	in_the_land_of_the_head_hunters
twin_dragons	twin_dragons
chhoti_si_baat	chhoti_si_baat
saath_saath_(film)	saath_saath_(film)
ramanaa_(film)	ramanaa_(film)
toni_(1935_film)	toni_(1935_film)
the_keys_of_the_kingdom_(film)	the_keys_of_the_kingdom_(film)
carry_on_camping	carry_on_camping
angel_rodriguez_(film)	angel_rodriguez_(film)
kalicharan	kalicharan
orca_(film)	orca_(film)
i'll_do_anything	i'll_do_anything
agni_natchathiram	agni_natchathiram
jamai_shashthi	jamai_shashthi
the_american_friend	the_american_friend
changes_(1969_film)	changes_(1969_film)
the_cannonball_run	the_cannonball_run
kushi_(2001_film)	kushi_(2001_film)
amalio_reyes,_un_hombre	amalio_reyes,_un_hombre
j._d.'s_revenge	j._d.'s_revenge
we_meet_at_tove's	we_meet_at_tove's
little_old_new_york	little_old_new_york
the_dawn_patrol_(1938_film)	the_dawn_patrol_(1938_film)
alexander's_ragtime_band_(film)	alexander's_ragtime_band_(film)
dharti_ke_lal	dharti_ke_lal
i_was_a_teenage_faust	i_was_a_teenage_faust
mississippi_masala	mississippi_masala
three_men_in_a_boat_(1956_film)	three_men_in_a_boat_(1956_film)
the_ninth_configuration	the_ninth_configuration
a_kid_for_two_farthings_(film)	a_kid_for_two_farthings_(film)
pepo_(film)	pepo_(film)
catchfire	catchfire
kizhakku_cheemayile	kizhakku_cheemayile
jait_re_jait	jait_re_jait
broken_barrier	broken_barrier
busters_verden	busters_verden
d.c._cab	d.c._cab
the_adventures_of_ford_fairlane	the_adventures_of_ford_fairlane
magudam	magudam
ghosts_of_girlfriends_past	ghosts_of_girlfriends_past
halo_(1996_film)	halo_(1996_film)
tunes_of_glory	tunes_of_glory
loins_of_punjab_presents	loins_of_punjab_presents
pokkiri	pokkiri
sword_of_the_beast	sword_of_the_beast
the_lost_world_(1960_film)	the_lost_world_(1960_film)
mackenna's_gold	mackenna's_gold
a_mighty_wind	a_mighty_wind
bopha!	bopha!
north_by_northwest	north_by_northwest
cold_fever	cold_fever
new_best_friend	new_best_friend
kingdom_of_the_spiders	kingdom_of_the_spiders
long_road_to_heaven	long_road_to_heaven
tum_bin	tum_bin
an_angel_at_my_table	an_angel_at_my_table
spy_kids	spy_kids
the_spider's_stratagem	the_spider's_stratagem
or_(my_treasure)	or_(my_treasure)
tap_roots	tap_roots
the_story_of_woo_viet	the_story_of_woo_viet
rush_hour_2	rush_hour_2
breakheart_pass_(film)	breakheart_pass_(film)
tera_mera_saath_rahen	tera_mera_saath_rahen
the_piano	the_piano
true_colors_(1991_film)	true_colors_(1991_film)
the_unholy_(1988_film)	the_unholy_(1988_film)
underfunded	underfunded
the_echo_of_thunder	the_echo_of_thunder
the_real_mccoy_(film)	the_real_mccoy_(film)
dracula_a.d._1972	dracula_a.d._1972
love_&_basketball	love_&_basketball
street_kings	street_kings
long_dark_night	long_dark_night
edges_of_the_lord	edges_of_the_lord
radio_flyer_(film)	radio_flyer_(film)
the_merry_widow_(1925_film)	the_merry_widow_(1925_film)
the_witches_(1966_film)	the_witches_(1966_film)
top_speed	top_speed
der_stern_von_afrika	der_stern_von_afrika
son_of_the_guardsman	son_of_the_guardsman
i,_monster	i,_monster
in_search_of_dr._seuss	in_search_of_dr._seuss
going_hollywood	going_hollywood
forgotten_silver	forgotten_silver
first_men_in_the_moon_(1964_film)	first_men_in_the_moon_(1964_film)
kattuviriyan	kattuviriyan
interiors	interiors
hotel_paradis	hotel_paradis
two-lane_blacktop	two-lane_blacktop
red_dawn	red_dawn
latitude_zero_(film)	latitude_zero_(film)
cimarron_(1960_film)	cimarron_(1960_film)
live_once,_die_twice	live_once,_die_twice
a_child_is_waiting	a_child_is_waiting
jallaad	jallaad
children_of_paradise	children_of_paradise
the_incredibly_true_adventure_of_two_girls_in_love	the_incredibly_true_adventure_of_two_girls_in_love
the_cocoanuts	the_cocoanuts
father_of_the_bride_(1950_film)	father_of_the_bride_(1950_film)
sanjuro	sanjuro
serious_moonlight_(2009_film)	serious_moonlight_(2009_film)
how_to_make_an_american_quilt	how_to_make_an_american_quilt
the_boat_on_the_grass	the_boat_on_the_grass
the_italian_job	the_italian_job
paisa_vasool	paisa_vasool
estate_violenta	estate_violenta
azhagi	azhagi
bird_on_a_wire_(film)	bird_on_a_wire_(film)
smash_palace	smash_palace
thaayillamal_naan_illai	thaayillamal_naan_illai
rani_theni	rani_theni
arlington_road	arlington_road
khuddar	khuddar
the_best_of_youth	the_best_of_youth
the_valley_of_gwangi	the_valley_of_gwangi
the_gorgon	the_gorgon
titanic_(1953_film)	titanic_(1953_film)
s.a.-mann_brand	s.a.-mann_brand
bajo_el_signo_de_la_patria	bajo_el_signo_de_la_patria
the_sorcerers	the_sorcerers
familia_rodante	familia_rodante
maine_gandhi_ko_nahin_mara	maine_gandhi_ko_nahin_mara
ore_kadal	ore_kadal
the_west_point_story_(film)	the_west_point_story_(film)
the_young_lions_(film)	the_young_lions_(film)
l'onorevole_angelina	l'onorevole_angelina
la_fidelidad	la_fidelidad
the_assassination_of_trotsky	the_assassination_of_trotsky
shyamol_chhaya	shyamol_chhaya
the_million_dollar_hotel	the_million_dollar_hotel
a_day_to_remember_(1953_film)	a_day_to_remember_(1953_film)
ganga_ki_saugandh	ganga_ki_saugandh
la_rage_de_l'ange	la_rage_de_l'ange
the_scent_of_green_papaya	the_scent_of_green_papaya
shaadi_se_pehle	shaadi_se_pehle
the_bay_boy	the_bay_boy
how_to_deal	how_to_deal
treed_murray	treed_murray
the_million_pound_note	the_million_pound_note
metropolis_(1927_film)	metropolis_(1927_film)
the_cowboy_way_(film)	the_cowboy_way_(film)
orders_is_orders	orders_is_orders
black_robe_(film)	black_robe_(film)
sympathy_for_the_underdog	sympathy_for_the_underdog
aadu_puli_attam_(1977_film)	aadu_puli_attam_(1977_film)
bachelor_flat	bachelor_flat
before_sunrise	before_sunrise
rab_ne_bana_di_jodi	rab_ne_bana_di_jodi
every_girl_should_be_married	every_girl_should_be_married
people_will_talk	people_will_talk
awaaz	awaaz
terrorvision	terrorvision
beverly_hills_brats	beverly_hills_brats
jude_(film)	jude_(film)
jodi_no.1	jodi_no.1
apasionados	apasionados
jazbaat_(1994_film)	jazbaat_(1994_film)
angel_baby_(1995_film)	angel_baby_(1995_film)
modern_problems	modern_problems
forest_of_the_gods	forest_of_the_gods
thamizhan	thamizhan
sathi_leelavathi_(1995_film)	sathi_leelavathi_(1995_film)
legends_of_the_fall	legends_of_the_fall
the_man_with_a_cloak	the_man_with_a_cloak
sky_high_(2005_film)	sky_high_(2005_film)
hermanas	hermanas
the_singing_ringing_tree	the_singing_ringing_tree
kid_glove_killer	kid_glove_killer
sankarlal	sankarlal
mughal-e-azam	mughal-e-azam
la_aventura_explosiva	la_aventura_explosiva
ladies_of_the_mob	ladies_of_the_mob
in_the_mirror_of_maya_deren	in_the_mirror_of_maya_deren
gangs_of_new_york	gangs_of_new_york
days_of_tomorrow	days_of_tomorrow
the_last_man_on_planet_earth	the_last_man_on_planet_earth
the_cabinet_of_caligari	the_cabinet_of_caligari
fengming,_a_chinese_memoir	fengming,_a_chinese_memoir
blink_(film)	blink_(film)
i_am_a_hotel	i_am_a_hotel
the_fox_(1967_film)	the_fox_(1967_film)
andha_kanoon	andha_kanoon
halls_of_montezuma_(film)	halls_of_montezuma_(film)
the_gentle_sex	the_gentle_sex
cosh_boy	cosh_boy
the_neanderthal_man	the_neanderthal_man
the_green_archer_(1940_serial)	the_green_archer_(1940_serial)
the_bloody_exorcism_of_coffin_joe	the_bloody_exorcism_of_coffin_joe
the_old_dark_house_(1963_film)	the_old_dark_house_(1963_film)
the_deadly_bees	the_deadly_bees
spinning_boris	spinning_boris
save_the_green_planet!	save_the_green_planet!
terminal_entry	terminal_entry
signs_of_life_(1968_film)	signs_of_life_(1968_film)
death_defying_acts	death_defying_acts
cold_blade	cold_blade
the_stepford_wives_(2004_film)	the_stepford_wives_(2004_film)
athadu	athadu
audace_colpo_dei_soliti_ignoti	audace_colpo_dei_soliti_ignoti
la_fuga	la_fuga
somberi	somberi
dead_man's_bluff	dead_man's_bluff
stella_(1990_film)	stella_(1990_film)
save_the_last_dance	save_the_last_dance
escape_from_sobibor	escape_from_sobibor
kabhi_haan_kabhi_naa	kabhi_haan_kabhi_naa
the_man_who_sued_god	the_man_who_sued_god
namak_halaal	namak_halaal
o_quatrilho	o_quatrilho
fatso_(1980_film)	fatso_(1980_film)
star_80	star_80
god's_little_acre_(film)	god's_little_acre_(film)
kasauti	kasauti
reservoir_dogs	reservoir_dogs
the_great_waldo_pepper	the_great_waldo_pepper
under_the_rainbow	under_the_rainbow
the_captain's_table	the_captain's_table
lawman_(film)	lawman_(film)
ganga_addara	ganga_addara
bada_kabutar	bada_kabutar
sliver_(film)	sliver_(film)
opera_(film)	opera_(film)
sikuru_tharuwa	sikuru_tharuwa
salaam_bombay!	salaam_bombay!
anthony_zimmer	anthony_zimmer
it's_in_the_bag!	it's_in_the_bag!
yeh_hai_jalwa	yeh_hai_jalwa
a_woman_in_transit	a_woman_in_transit
zoo_in_budapest	zoo_in_budapest
sabapathy	sabapathy
tetro	tetro
it's_a_wonderful_world_(1939_film)	it's_a_wonderful_world_(1939_film)
hey_there,_it's_yogi_bear!	hey_there,_it's_yogi_bear!
deewaar_(1975_film)	deewaar_(1975_film)
shotguns_that_kick	shotguns_that_kick
ru_ba_ru	ru_ba_ru
gundaraj	gundaraj
risky_business	risky_business
china_girl_(1942_film)	china_girl_(1942_film)
the_rookie_(1990_film)	the_rookie_(1990_film)
mr._arkadin	mr._arkadin
male_companion	male_companion
i_see_a_dark_stranger	i_see_a_dark_stranger
tum_se_achcha_kaun_hai	tum_se_achcha_kaun_hai
fogo_de_palha	fogo_de_palha
papillon_(film)	papillon_(film)
sangram_(1993_film)	sangram_(1993_film)
stolen_harmony	stolen_harmony
weeds_(film)	weeds_(film)
jagriti	jagriti
there_is_another_sun	there_is_another_sun
the_concorde_..._airport_'79	the_concorde_..._airport_'79
david_(1988_film)	david_(1988_film)
dost_(1974_film)	dost_(1974_film)
q_(film)	q_(film)
lotte_from_gadgetville	lotte_from_gadgetville
she's_out_of_control	she's_out_of_control
lal_ronger_duniya	lal_ronger_duniya
1._april_2000	1._april_2000
ek_alag_mausam	ek_alag_mausam
opal_dream	opal_dream
captain_from_castile	captain_from_castile
business_is_business_(film)	business_is_business_(film)
naqaab	naqaab
laburnum_grove	laburnum_grove
december_pookal	december_pookal
aradhana_(1969_film)	aradhana_(1969_film)
adventure_island_(film)	adventure_island_(film)
like_two_crocodiles	like_two_crocodiles
cocaine_cowboys	cocaine_cowboys
isn't_she_great	isn't_she_great
investigating_sex	investigating_sex
the_jackpot	the_jackpot
en_slem_dreng	en_slem_dreng
slither_(1973_film)	slither_(1973_film)
boxing_gloves_(film)	boxing_gloves_(film)
kasthooriman	kasthooriman
in_name_only	in_name_only
all_my_loved_ones	all_my_loved_ones
laaj	laaj
hellcats_of_the_navy	hellcats_of_the_navy
puriyaadha_pudhir	puriyaadha_pudhir
teenage_zombies	teenage_zombies
weekend_lover	weekend_lover
dead_mary	dead_mary
vel_(film)	vel_(film)
johny_mera_naam	johny_mera_naam
the_adventures_of_marco_polo	the_adventures_of_marco_polo
okkadunnadu	okkadunnadu
day_of_the_outlaw	day_of_the_outlaw
vidhaata	vidhaata
rare_birds	rare_birds
harold_&_kumar_go_to_white_castle	harold_&_kumar_go_to_white_castle
tezaab	tezaab
souten	souten
contraband_(1980_film)	contraband_(1980_film)
spaceballs	spaceballs
the_policeman	the_policeman
anything_for_love	anything_for_love
oi_thalassies_oi_hadres	oi_thalassies_oi_hadres
grey_owl_(film)	grey_owl_(film)
irene_(1940_film)	irene_(1940_film)
little_darlings	little_darlings
sattam	sattam
the_god_of_cookery	the_god_of_cookery
ekka_raja_rani	ekka_raja_rani
aaru_(film)	aaru_(film)
cerro_guanaco	cerro_guanaco
rich_in_love	rich_in_love
cold_turkey_(film)	cold_turkey_(film)
the_last_sunset_(film)	the_last_sunset_(film)
sangamam	sangamam
the_air_i_breathe	the_air_i_breathe
les_malheurs_d'alfred	les_malheurs_d'alfred
welcome_to_dongmakgol	welcome_to_dongmakgol
dracula_(1958_film)	dracula_(1958_film)
elite_squad	elite_squad
the_governess	the_governess
wish_upon_a_star	wish_upon_a_star
kahaani	kahaani
black_moon_rising	black_moon_rising
the_cricket_(film)	the_cricket_(film)
om_shanti_om	om_shanti_om
bobbili_puli	bobbili_puli
titash_ekti_nadir_naam	titash_ekti_nadir_naam
throne_of_blood	throne_of_blood
police_chief_pepe	police_chief_pepe
the_voyeur_(1970_film)	the_voyeur_(1970_film)
bandit_queen	bandit_queen
the_missing_gun	the_missing_gun
the_hunting_party_(2007_film)	the_hunting_party_(2007_film)
a_sawmill_hazard	a_sawmill_hazard
the_day_i_became_a_woman	the_day_i_became_a_woman
the_tin_star	the_tin_star
hell_to_eternity	hell_to_eternity
the_truth_about_charlie	the_truth_about_charlie
main_hoon_na	main_hoon_na
a_generation	a_generation
mankillers	mankillers
alli_arjuna	alli_arjuna
alive_(1993_film)	alive_(1993_film)
red_(2002_film)	red_(2002_film)
the_palm_beach_story	the_palm_beach_story
convict_99	convict_99
king_uncle	king_uncle
ming_ming	ming_ming
callaway_went_thataway	callaway_went_thataway
necessary_roughness_(film)	necessary_roughness_(film)
youngblood_(1986_film)	youngblood_(1986_film)
letters_from_a_killer	letters_from_a_killer
mujhse_shaadi_karogi	mujhse_shaadi_karogi
au_secours!	au_secours!
ma_6-t_va_crack-er	ma_6-t_va_crack-er
thirteen_princess_trees	thirteen_princess_trees
a_day_without_a_mexican	a_day_without_a_mexican
pacific_heights_(film)	pacific_heights_(film)
beau_brummell_(film)	beau_brummell_(film)
my_tutor_friend	my_tutor_friend
flower_&_garnet	flower_&_garnet
the_desperate_hours_(film)	the_desperate_hours_(film)
we're_no_angels_(1989_film)	we're_no_angels_(1989_film)
vasool_raja_mbbs	vasool_raja_mbbs
maha_chor	maha_chor
speaking_in_strings	speaking_in_strings
autumn_sonata	autumn_sonata
vildledt_elskov	vildledt_elskov
biker_boyz	biker_boyz
infinity_(film)	infinity_(film)
