timeless_(martina_mcbride_album)	timeless_(martina_mcbride_album)
fly_to_the_rainbow	fly_to_the_rainbow
famous_graves	famous_graves
goodbye_girl_(miyuki_nakajima_album)	goodbye_girl_(miyuki_nakajima_album)
trust_the_tangerine_peel	trust_the_tangerine_peel
i_heard_it_today	i_heard_it_today
the_code_is_red...long_live_the_code	the_code_is_red...long_live_the_code
crack_the_skye	crack_the_skye
b-side_(album)	b-side_(album)
beyond_rangoon_(soundtrack)	beyond_rangoon_(soundtrack)
bags_&_flutes	bags_&_flutes
mingus_plays_piano	mingus_plays_piano
born_naked	born_naked
gladiator_(soundtrack)	gladiator_(soundtrack)
tibi_et_igni	tibi_et_igni
tiny_dynamine	tiny_dynamine
lonesome_standard_time	lonesome_standard_time
high_mileage	high_mileage
wild_streak	wild_streak
full_colors	full_colors
put_yourself_in_my_shoes	put_yourself_in_my_shoes
war_eternal	war_eternal
noima	noima
look_into_the_eyeball	look_into_the_eyeball
off_the_deep_end_(the_friday_night_boys_album)	off_the_deep_end_(the_friday_night_boys_album)
real_to_reel_(marillion_album)	real_to_reel_(marillion_album)
good_time_(album)	good_time_(album)
write_you_a_song	write_you_a_song
run_devil_run_(album)	run_devil_run_(album)
headhunter_(album)	headhunter_(album)
trouble_at_the_henhouse	trouble_at_the_henhouse
broken_blossom	broken_blossom
poems,_prayers_&_promises	poems,_prayers_&_promises
pos_allazei_o_kairos	pos_allazei_o_kairos
gia_proti_fora	gia_proti_fora
god_(rebecca_st._james_album)	god_(rebecca_st._james_album)
christmas_with_the_rat_pack	christmas_with_the_rat_pack
hydrology_(album)	hydrology_(album)
801_live	801_live
the_game_is_thick,_vol._2	the_game_is_thick,_vol._2
equator_(uriah_heep_album)	equator_(uriah_heep_album)
fear_(john_cale_album)	fear_(john_cale_album)
tarpaper_sky	tarpaper_sky
home_for_christmas_(hall_&_oates_album)	home_for_christmas_(hall_&_oates_album)
four_for_trane	four_for_trane
heliocentric_(paul_weller_album)	heliocentric_(paul_weller_album)
l'homme_de_la_mancha	l'homme_de_la_mancha
tuba_sounds	tuba_sounds
don't_be_afraid_of_the_dark_(album)	don't_be_afraid_of_the_dark_(album)
samba_para_dos	samba_para_dos
dragon's_kiss	dragon's_kiss
eye_of_a_hurricane	eye_of_a_hurricane
life_between_the_exit_signs	life_between_the_exit_signs
diploid_love	diploid_love
mott_(album)	live_(mott_the_hoople_album)
the_greatest_hits_collection_(alan_jackson_album)	the_greatest_hits_collection_(alan_jackson_album)
eastern_wind	eastern_wind
interview_with_the_vampire_(soundtrack)	interview_with_the_vampire_(soundtrack)
quiet_please..._the_new_best_of_nick_lowe	quiet_please..._the_new_best_of_nick_lowe
wake-up_call_(album)	wake-up_call_(album)
crazy_legs_(album)	crazy_legs_(album)
chuck_berry_is_on_top	chuck_berry_is_on_top
good_move!	good_move!
tokyo,_oklahoma	tokyo,_oklahoma
heart_of_a_gangsta,_mind_of_a_hustla,_tongue_of_a_pimp	heart_of_a_gangsta,_mind_of_a_hustla,_tongue_of_a_pimp
back_home_(caedmon's_call_album)	back_home_(caedmon's_call_album)
sinners_international	sinners_international
beach_boys_concert	beach_boys_concert
trinity_(my_dying_bride_album)	trinity_(my_dying_bride_album)
interiors_(rosanne_cash_album)	interiors_(rosanne_cash_album)
my_own_lane	my_own_lane
love_death_immortality	love_death_immortality
caustic_love	caustic_love
manifestation_(album)	manifestation_(album)
live_in_new_york_(laurie_anderson_album)	live_in_new_york_(laurie_anderson_album)
let_my_children_hear_music	let_my_children_hear_music
mentally_murdered	mentally_murdered
from_water_to_war	from_water_to_war
vacancy_(ep)	vacancy_(ep)
flare_gun	flare_gun
the_eastern_moods_of_ahmed_abdul-malik	the_eastern_moods_of_ahmed_abdul-malik
b.a.r._(bay_area_representatives)	b.a.r._(bay_area_representatives)
last_time_i_saw_him	last_time_i_saw_him
eaten_alive_(album)	eaten_alive_(album)
on_the_nile	on_the_nile
marchand_de_cailloux	marchand_de_cailloux
into_somethin'	into_somethin'
the_delivery_man	the_delivery_man
the_very_best_of_tracy_lawrence	all_wrapped_up_in_christmas
fever_(kylie_minogue_album)	fever_(kylie_minogue_album)
freedom_(michael_w._smith_album)	freedom_(michael_w._smith_album)
transcendence_(crimson_glory_album)	transcendence_(crimson_glory_album)
a_state_of_trance_2014	a_state_of_trance_2014
the_individualist	the_individualist
a_state_of_trance_2013	intense
my_skin_is_cold	my_skin_is_cold
change_your_world_(michael_w._smith_album)	change_your_world_(michael_w._smith_album)
anti-diluvian_chronicles	anti-diluvian_chronicles
fm_s.h.e	fm_s.h.e
mo'_greens_please	mo'_greens_please
hanging_in_the_balance	hanging_in_the_balance
here's_to_the_ladies	here's_to_the_ladies
flag_(james_taylor_album)	flag_(james_taylor_album)
if_i_had_one_chance_to_tell_you_something	if_i_had_one_chance_to_tell_you_something
happy_songs_for_happy_people	happy_songs_for_happy_people
ocean_rain	ocean_rain
sam_cooke_at_the_copa	sam_cooke_at_the_copa
live_at_ronnie_scott's_(nina_simone_album)	live_at_ronnie_scott's_(nina_simone_album)
the_age_of_nero	my_skin_is_cold
live_destruction_at_no_fun_2007	live_destruction_at_no_fun_2007
piano_interpretations	piano_interpretations
pleasant_screams	pleasant_screams
behind_the_light	behind_the_light
beyond_the_valley...	beyond_the_valley...
waitin'_on_sundown	waitin'_on_sundown
two's_missing	two's_missing
don't_it_drag_on	don't_it_drag_on
man_in_the_hills	man_in_the_hills
ratne_igre	ratne_igre
love_tracks_(gloria_gaynor_album)	love_tracks_(gloria_gaynor_album)
the_essential_alan_parsons_project	the_essential_alan_parsons_project
straight_from_the_lab	straight_from_the_lab
take_the_weather_with_you	take_the_weather_with_you
guy_(album)	guy_(album)
tamaki_nami_reproduct_best	tamaki_nami_reproduct_best
if_we're_honest	if_we're_honest
live_at_symphonica_in_rosso	live_at_symphonica_in_rosso
7_samurai_sessions_-we're_kavki_boiz-	7_samurai_sessions_-we're_kavki_boiz-
happy_with_what_you_have_to_be_happy_with	happy_with_what_you_have_to_be_happy_with
seed_eight	seed_eight
nashville_rebel_(box_set)	nashville_rebel_(box_set)
12_string_guitar!_vol._2	12_string_guitar!_vol._2
move_on_over	move_on_over
supersonic_girl	supersonic_girl
masami_kobushi	masami_kobushi
natasa	natasa
polar_ac	polar_ac
joy_of_a_toy	joy_of_a_toy
days_of_abandon	days_of_abandon
you_win_again_(album)	you_win_again_(album)
outskirts_of_town	outskirts_of_town
full_cold_moon	full_cold_moon
laughing_on_the_outside	laughing_on_the_outside
future_souls	future_souls
stolen_apples_(album)	stolen_apples_(album)
s'il_suffisait_d'aimer	s'il_suffisait_d'aimer
decoy_(album)	decoy_(album)
play_dirty_(album)	play_dirty_(album)
david_bowie_(1967_album)	david_bowie_(1967_album)
echoes_in_a_shallow_bay	echoes_in_a_shallow_bay
the_lights_from_the_chemical_plant	the_lights_from_the_chemical_plant
greatest_hits_volume_2_(james_taylor_album)	greatest_hits_volume_2_(james_taylor_album)
all_about_eve_(album)	all_about_eve_(album)
amigos_(santana_album)	amigos_(santana_album)
little_ship_(album)	little_ship_(album)
mazi_sou_(album)	mazi_sou_(album)
all_i_want_(tim_mcgraw_album)	all_i_want_(tim_mcgraw_album)
cliff_'em_all	cliff_'em_all
all_systems_go_(vinnie_vincent_invasion_album)	all_systems_go_(vinnie_vincent_invasion_album)
a_love_supreme	a_love_supreme
paul_mccartney_live_in_los_angeles	amoeba's_secret
the_five_faces_of_manfred_mann	the_five_faces_of_manfred_mann
heavy_soul_(paul_weller_album)	heavy_soul_(paul_weller_album)
transform_(rebecca_st._james_album)	transform_(rebecca_st._james_album)
easy_come,_easy_go_(george_strait_album)	easy_come,_easy_go_(george_strait_album)
taylor's_wailers	taylor's_wailers
no_bull	no_bull
music_for_robots	music_for_robots
kings_of_metal	kings_of_metal
the_buddy_holly_story,_vol._2	the_buddy_holly_story,_vol._2
talk_is_cheap_vol_iv	talk_is_cheap_vol_iv
the_love_songs_(chris_de_burgh_album)	the_love_songs_(chris_de_burgh_album)
deceiver_(muslimgauze_album)	deceiver_(muslimgauze_album)
prairie_home_invasion	prairie_home_invasion
the_boss_(diana_ross_album)	the_boss_(diana_ross_album)
the_greatest_songs_of_the_seventies	the_greatest_songs_of_the_seventies
acoustics_(hella_ep)	acoustics_(hella_ep)
a_decade_in_the_grave	a_decade_in_the_grave
john_coltrane_with_the_red_garland_trio	john_coltrane_with_the_red_garland_trio
two_horizons	two_horizons
killing_the_dragon	killing_the_dragon
bulletproof_picasso	bulletproof_picasso
talk_is_cheap_vol_ii	talk_is_cheap_vol_ii
draft_7.30	draft_7.30
that's_nat	that's_nat
machine_gun_in_the_clown's_hand	machine_gun_in_the_clown's_hand
blessing_in_disguise_(metal_church_album)	blessing_in_disguise_(metal_church_album)
puzzle_people	puzzle_people
metal_discharge	metal_discharge
misfits_2	misfits_2
the_robe_(album)	the_robe_(album)
harmony_(three_dog_night_album)	harmony_(three_dog_night_album)
music_of_final_fantasy_ix	music_of_final_fantasy_ix
music_of_final_fantasy_iv	music_of_final_fantasy_iv
green_thoughts	green_thoughts
universal_religion_chapter_7	intense
four_foot_shack	four_foot_shack
carmen_sings_monk	carmen_sings_monk
live_my_life	live_my_life
goin'_back_to_indiana	goin'_back_to_indiana
we're_here_because_we're_here	we're_here_because_we're_here
aretha_live_at_fillmore_west	aretha_live_at_fillmore_west
familiar_to_millions	familiar_to_millions
3_balloons	3_balloons
'round_about_midnight	'round_about_midnight
what_i_do	what_i_do
bone_&_bari	bone_&_bari
miles_in_tokyo	miles_in_tokyo
hallelujah,_he_is_born	hallelujah,_he_is_born
the_gold_experience	the_gold_experience
spiral_circus	spiral_circus
overnight_motorcycle_music	overnight_motorcycle_music
discography_of_mobile_suit_gundam_00	discography_of_mobile_suit_gundam_00
alpha_(alice_nine_album)	alpha_(alice_nine_album)
empire_of_the_undead	empire_of_the_undead
junction_seven	junction_seven
move_back_home	move_back_home
believer_(chic_album)	believer_(chic_album)
samba_esquema_novo	samba_esquema_novo
but_seriously,_folks...	but_seriously,_folks...
satanstornade	satanstornade
yes_(yes_album)	yes_(yes_album)
in_the_wee_small_hours	in_the_wee_small_hours
got_that_feeling!	got_that_feeling!
ultima_ii_massage	ultima_ii_massage
metallica_(album)	metallica_(album)
hoop_life	hoop_life
odyssey_(yngwie_malmsteen_album)	odyssey_(yngwie_malmsteen_album)
akvaario	akvaario
yo_ho!_poor_you,_little_me	yo_ho!_poor_you,_little_me
hipeponymous	hipeponymous
war_child_presents_heroes	war_child_presents_heroes
mr._snowman	mr._snowman
choir_of_echoes	choir_of_echoes
the_best_of_joe_walsh	but_seriously,_folks...
dirges_of_elysium	dirges_of_elysium
platinum_(mike_oldfield_album)	platinum_(mike_oldfield_album)
the_killing_fields_(album)	the_killing_fields_(album)
il_mare_calmo_della_sera	il_mare_calmo_della_sera
the_art_of_celebration	the_art_of_celebration
live_at_texas_stadium	live_at_texas_stadium
da_capo_(love_album)	da_capo_(love_album)
vrooom_vrooom	vrooom_vrooom
will_the_wolf_survive	will_the_wolf_survive
funny_how_sweet_co-co_can_be	funny_how_sweet_co-co_can_be
junkyard_hearts	junkyard_hearts
vaudeville_villain	vaudeville_villain
close_up_(joey_yung_album)	close_up_(joey_yung_album)
philosopher's_propeller	philosopher's_propeller
straight_up_(album)	straight_up_(album)
v-sit	v-sit
daydream_forever	daydream_forever
cuttin'_capers_(album)	cuttin'_capers_(album)
breaking_point!	breaking_point!
budd_(ep)	budd_(ep)
queen_forever	queen_forever
frampton_comes_alive!	frampton_comes_alive!
delicate_sound_of_thunder	delicate_sound_of_thunder
the_radiolarian_series	the_radiolarian_series
paradise_(john_anderson_album)	greatest_hits_(1996_john_anderson_album)
loose...	loose...
ikebukuro_dada	ikebukuro_dada
lou_takes_off	lou_takes_off
champions_of_rock	champions_of_rock
the_essential_elvis_presley	the_essential_elvis_presley
out_of_body_(album)	out_of_body_(album)
cliff_craft	cliff_craft
donkey_rhubarb_(ep)	donkey_rhubarb_(ep)
j._j._johnson's_jazz_quintets	j._j._johnson's_jazz_quintets
a_dotted_line	a_dotted_line
love_me_or_leave_me_(doris_day_album)	love_me_or_leave_me_(doris_day_album)
the_riddle_(album)	the_riddle_(album)
down_to_earth_(ozzy_osbourne_album)	down_to_earth_(ozzy_osbourne_album)
remixploitation	remixploitation
tracy_chapman_(album)	tracy_chapman_(album)
memoirs_of_a_geisha_(soundtrack)	memoirs_of_a_geisha_(soundtrack)
into_glory_ride	into_glory_ride
speed_circus	speed_circus
walk_through_walls	walk_through_walls
fish_inn	fish_inn
it_won't_be_christmas_without_you	it_won't_be_christmas_without_you
mtv_unplugged_(10,000_maniacs_album)	mtv_unplugged_(10,000_maniacs_album)
apla_ta_pragmata	apla_ta_pragmata
the_stylings_of_silver	the_stylings_of_silver
nights_behind_the_tree_line	nights_behind_the_tree_line
london_symphony_orchestra,_vol._i	london_symphony_orchestra,_vol._i
lowborn	lowborn
bennie_green_blows_his_horn	bennie_green_blows_his_horn
beatles_for_sale	beatles_for_sale
thick_as_thieves_(trooper_album)	thick_as_thieves_(trooper_album)
deer_lodge_george_jones	deer_lodge_george_jones
classics_(jennifer_rush_album)	classics_(jennifer_rush_album)
how_to_make_gravy	how_to_make_gravy
the_fountain_(album)	the_fountain_(album)
doolittle_(album)	doolittle_(album)
dawn_of_the_brave	dawn_of_the_brave
la_diva_(aretha_franklin_album)	la_diva_(aretha_franklin_album)
i_wanna_be_your_man_(ep)	i_wanna_be_your_man_(ep)
live_at_london's_talk_of_the_town_(the_temptations_album)	live_at_london's_talk_of_the_town_(the_temptations_album)
bulletboys_(album)	bulletboys_(album)
go_west_young_man_(michael_w._smith_album)	go_west_young_man_(michael_w._smith_album)
die_knowing	die_knowing
alice_cooper_goes_to_hell	alice_cooper_goes_to_hell
quaudiophiliac	quaudiophiliac
rage_on	rage_on
alternative_chartbusters_(stiff_little_fingers_album)	alternative_chartbusters_(stiff_little_fingers_album)
blissfucker	blissfucker
holding_my_own	holding_my_own
mince_spies	mince_spies
rock_'n'_roll_telephone	rock_'n'_roll_telephone
klang_(album)	klang_(album)
ten_out_of_10	ten_out_of_10
dreaming_no._11	dreaming_no._11
the_necrotic_manifesto	the_necrotic_manifesto
sha-kon-o-hey!_land_of_blue_smoke	sha-kon-o-hey!_land_of_blue_smoke
22_more_hits	22_more_hits
sogno	sogno
true_believer_(sawyer_brown_album)	true_believer_(sawyer_brown_album)
the_complete_capitol_singles_collection	the_complete_capitol_singles_collection
last_man_on_earth_(album)	last_man_on_earth_(album)
these_are_special_times	these_are_special_times
ma-king	ma-king
hakol_ze_letova	hakol_ze_letova
hypnotic_eye	hypnotic_eye
all_aboard_the_blue_train	all_aboard_the_blue_train
fireworks_(bonfire_album)	fireworks_(bonfire_album)
beach_house_on_the_moon	beach_house_on_the_moon
history_(loudon_wainwright_iii_album)	history_(loudon_wainwright_iii_album)
anjunabeats_volume_11	anjunabeats_volume_11
organic_(joe_cocker_album)	organic_(joe_cocker_album)
universal_consciousness	universal_consciousness
six_feet_down_under	2_of_one
tombo_(album)	tombo_(album)
word_o.k.	word_o.k.
i_can_hear_the_heart_beating_as_one	i_can_hear_the_heart_beating_as_one
mtv_unplugged_(tony_bennett_album)	mtv_unplugged_(tony_bennett_album)
another_side_of_bob_dylan	another_side_of_bob_dylan
warszawa_(porcupine_tree_album)	warszawa_(porcupine_tree_album)
transmission_iv	transmission_iv
animetal_marathon_iii	animetal_marathon_iii
when_all_the_pieces_fit	when_all_the_pieces_fit
kylie's_non-stop_history_50+1	kylie's_non-stop_history_50+1
at_war_with_reality	at_war_with_reality
my_life_in_the_bush_of_ghosts_(album)	my_life_in_the_bush_of_ghosts_(album)
live_at_austin_city_limits_festival	live_at_austin_city_limits_festival
the_fabulous_miracles	the_fabulous_miracles
grown_up_overnight	grown_up_overnight
live_in_paris_zenith_'88	live_in_paris_zenith_'88
connie_francis_sings_award_winning_motion_picture_hits	connie_francis_sings_award_winning_motion_picture_hits
dirty_diamonds	dirty_diamonds
magical_journey	magical_journey
lord_steppington	lord_steppington
hillbilly_deluxe_(brooks_&_dunn_album)	hillbilly_deluxe_(brooks_&_dunn_album)
back_around	back_around
rough_cutt_(album)	rough_cutt_(album)
it's_2_easy	it's_2_easy
imaginary_diseases	imaginary_diseases
demolition_man_(soundtrack)	demolition_man_(soundtrack)
diana!	diana!
apocalyptic_raids	apocalyptic_raids
aart	aart
queen_of_hip-pop	queen_of_hip-pop
god_fixation	god_fixation
la_mia_risposta	la_mia_risposta
the_mountain_(heartless_bastards_album)	the_mountain_(heartless_bastards_album)
the_twenty-fifth_anniversary_anthology	the_twenty-fifth_anniversary_anthology
jackie_mclean_&_co.	jackie_mclean_&_co.
radiance_(album)	radiance_(album)
puppet_strings	puppet_strings
shutup_&_jam!	shutup_&_jam!
going_for_myself	going_for_myself
the_essential_anna_vissi	the_essential_anna_vissi
the_rainbow_children	the_rainbow_children
the_1999_party	the_1999_party
speak_no_evil	speak_no_evil
reflections_(b.b._king_album)	reflections_(b.b._king_album)
16_wit_dre	16_wit_dre
make_up_city	make_up_city
provoked_(album)	provoked_(album)
elektrozorn_vol._1	elektrozorn_vol._1
circle_in_the_round	circle_in_the_round
infernal_overkill	infernal_overkill
what_a_feelin'	what_a_feelin'
all_wrapped_up_in_christmas	all_wrapped_up_in_christmas
alice_in_wonderland_(alice_nine_album)	alice_in_wonderland_(alice_nine_album)
that_don't_make_me_a_bad_guy	that_don't_make_me_a_bad_guy
shrink_dust	shrink_dust
satellite_rides	satellite_rides
parallels_(album)	parallels_(album)
world_wide_live	world_wide_live
the_new_classic	the_new_classic
level_five_(ep)	level_five_(ep)
dion_chante_plamondon	dion_chante_plamondon
trompeta_toccata	trompeta_toccata
at_the_cafe_bohemia,_vol._2	at_the_cafe_bohemia,_vol._2
tongue_in_chic	tongue_in_chic
at_the_cafe_bohemia,_vol._1	at_the_cafe_bohemia,_vol._1
lost_channels	lost_channels
the_amazing_bud_powell	the_amazing_bud_powell
darling_(ep)	darling_(ep)
resonance_(anathema_album)	resonance_(anathema_album)
strangers_in_the_night_(frank_sinatra_album)	strangers_in_the_night_(frank_sinatra_album)
collection_(arvingarna_album)	collection_(arvingarna_album)
rockin'_the_boat	rockin'_the_boat
bhb_(album)	bhb_(album)
bring_me_the_head_of_yuri_gagarin	bring_me_the_head_of_yuri_gagarin
guilty_'til_proved_innocent!	guilty_'til_proved_innocent!
antagonise	antagonise
back_country_suite	back_country_suite
matono	matono
adult_entertainment_(album)	adult_entertainment_(album)
money_talks_(trooper_album)	money_talks_(trooper_album)
early_orbison	early_orbison
digital_resistance	digital_resistance
taru_(album)	taru_(album)
when_incubus_attacks_volume_1	when_incubus_attacks_volume_1
our_time_has_come	our_time_has_come
mountain_soul	mountain_soul
can_you_hear_me_now	can_you_hear_me_now
isn't_anything	isn't_anything
up_to_here	up_to_here
aurora_(susumu_hirasawa_album)	aurora_(susumu_hirasawa_album)
boogadaboogadaboogada!	boogadaboogadaboogada!
our_man_in_paris	our_man_in_paris
koda_kumi_driving_hit's_6	koda_kumi_driving_hit's_6
quadrophenia_live_in_london	quadrophenia_live_in_london
brutal_planet	brutal_planet
beyond_the_valley_of_the_gift_police	beyond_the_valley_of_the_gift_police
the_essential_barry_manilow	the_essential_barry_manilow
last_chance_to_dance_trance_(perhaps)	last_chance_to_dance_trance_(perhaps)
wig_out_at_jagbags	wig_out_at_jagbags
burnt_offerings_(album)	burnt_offerings_(album)
let's_part_in_style	let's_part_in_style
tigerdrottningen	tigerdrottningen
albert_ayler_in_greenwich_village	albert_ayler_in_greenwich_village
majikat	majikat
a_new_perspective	a_new_perspective
sortie_(album)	sortie_(album)
diana_ross_&_the_supremes_join_the_temptations	diana_ross_&_the_supremes_join_the_temptations
live_in_japan_(sarah_vaughan_album)	live_in_japan_(sarah_vaughan_album)
the_morning_after_(j._geils_band_album)	the_morning_after_(j._geils_band_album)
all_for_one_(the_screaming_jets_album)	all_for_one_(the_screaming_jets_album)
kidz_bop_25	kidz_bop_25
decent_work_for_decent_pay	decent_work_for_decent_pay
baby_(bosque_brown_album)	baby_(bosque_brown_album)
kidz_bop_26	kidz_bop_26
experience_gloria_gaynor	experience_gloria_gaynor
through_art_we_are_all_equals	through_art_we_are_all_equals
only_life	only_life
comet,_come_to_me	comet,_come_to_me
abandoned_luncheonette	abandoned_luncheonette
ask_forgiveness	ask_forgiveness
vres_enan_tropo	vres_enan_tropo
hristougenna_me_tin_katy	hristougenna_me_tin_katy
blowing_in_from_chicago	blowing_in_from_chicago
amazing_grace_(aretha_franklin_album)	amazing_grace_(aretha_franklin_album)
poemss	poemss
one_more_from_the_road	one_more_from_the_road
l.a._confidential_(soundtrack)	l.a._confidential_(soundtrack)
xmii	xmii
echo_&_the_bunnymen_(album)	echo_&_the_bunnymen_(album)
live_in_auburn,_wa	live_in_auburn,_wa
best-of_(anggun_album)	elevation_(anggun_album)
temptations_live!	temptations_live!
right_or_wrong_(george_strait_album)	right_or_wrong_(george_strait_album)
sign_of_the_hammer	sign_of_the_hammer
sonny_stitt_with_the_new_yorkers	sonny_stitt_with_the_new_yorkers
best_of_animetal	best_of_animetal
pull_my_chain	pull_my_chain
one_(neal_morse_album)	one_(neal_morse_album)
darker_than_darkness_-style_93-	darker_than_darkness_-style_93-
madman_across_the_water	madman_across_the_water
devotion_(masami_okui_album)	devotion_(masami_okui_album)
hammer_&_nail	hammer_&_nail
astral_weeks	astral_weeks
hall_of_the_mountain_grill	hall_of_the_mountain_grill
rebecca_st._james_(album)	rebecca_st._james_(album)
the_songstress	the_songstress
lie_down_in_the_light	lie_down_in_the_light
atomhenge_76	atomhenge_76
merzbox	paradoxa_paradoxa
merzbox	merzbox
jazz_at_massey_hall	jazz_at_massey_hall
i'll_give_all_my_love_to_you	i'll_give_all_my_love_to_you
from_scotland_with_love	from_scotland_with_love
from_nowhere	from_nowhere
beyond_belief_(album)	beyond_belief_(album)
quadrama	quadrama
hang_on_to_each_other	hang_on_to_each_other
barry_manilow_(1973_album)	barry_manilow_(1973_album)
forever,_for_always,_for_love	forever,_for_always,_for_love
counting_other_peoples_money	counting_other_peoples_money
doom_abuse	doom_abuse
dance_with_my_father	the_essential_luther_vandross
kudos_to_you!	kudos_to_you!
the_dealer	the_dealer
high_life_(wayne_shorter_album)	high_life_(wayne_shorter_album)
ocean_front_property	ocean_front_property
after_all_(album)	after_all_(album)
d's_new_attraction	d's_new_attraction
when_farmer_met_gryce	when_farmer_met_gryce
the_barbra_streisand_album	the_barbra_streisand_album
frankly_sentimental	frankly_sentimental
the_musings_of_miles	the_musings_of_miles
zoot_allures	zoot_allures
the_river_&_the_thread	the_river_&_the_thread
speak_of_the_devil_(ozzy_osbourne_album)	speak_of_the_devil_(ozzy_osbourne_album)
lp5	lp5
live_(luciano)	live_(luciano)
greatest_hits_(the_specials_album)	greatest_hits_(the_specials_album)
small_town_heroes	small_town_heroes
signs_of_life_(billy_squier_album)	signs_of_life_(billy_squier_album)
the_rolling_stones_no._2	the_rolling_stones_no._2
freedom_(neil_young_album)	freedom_(neil_young_album)
i_feel_for_you_(album)	i_feel_for_you_(album)
angela's_ashes_(soundtrack)	angela's_ashes_(soundtrack)
the_getaway_(album)	the_getaway_(album)
fall_in_love_&_songs	fall_in_love_&_songs
ray_gun_suitcase	ray_gun_suitcase
let_the_good_times_roll_(album)	let_the_good_times_roll_(album)
i_love_you_(diana_ross_album)	i_love_you_(diana_ross_album)
catacombs_of_the_black_vatican	catacombs_of_the_black_vatican
sandtrafikar	sandtrafikar
candy_(lee_morgan_album)	candy_(lee_morgan_album)
union_terminology	union_terminology
surfer_girl	surfer_girl
burn_your_fire_for_no_witness	burn_your_fire_for_no_witness
healing_(todd_rundgren_album)	healing_(todd_rundgren_album)
el_regreso_del_sobreviviente	el_regreso_del_sobreviviente
something_special_(george_strait_album)	something_special_(george_strait_album)
the_compositions_of_al_cohn	the_compositions_of_al_cohn
go_insane	go_insane
the_mike_oldfield_ep	the_mike_oldfield_ep
let's_get_to_it	let's_get_to_it
izitso	izitso
music_@_work	music_@_work
neon_icon	neon_icon
the_power_of_love_(fish_leong_album)	the_power_of_love_(fish_leong_album)
wild_cherry_(album)	wild_cherry_(album)
fatou	fatou
viva_last_blues	viva_last_blues
trial_by_fire_(yngwie_malmsteen_album)	trial_by_fire_(yngwie_malmsteen_album)
forty_licks	forty_licks
the_big_ka-boom,_pt._1	the_big_ka-boom,_pt._1
blue_(joni_mitchell_album)	blue_(joni_mitchell_album)
summer_in_the_southeast	summer_in_the_southeast
ep+6	ep+6
die_without_hope	die_without_hope
supernal_liberty	supernal_liberty
songs_by_tom_lehrer	songs_by_tom_lehrer
chet_baker_sings	chet_baker_sings
jazz_for_the_thinker	jazz_for_the_thinker
sarkology	sarkology
gettin'_ready	gettin'_ready
lambo_(album)	lambo_(album)
coming_back_to_you	coming_back_to_you
crashing_through	crashing_through
sun_structures	sun_structures
find_your_harmony	find_your_harmony
minazo_vol._1	minazo_vol._1
from_the_inside_(laura_pausini_album)	from_the_inside_(laura_pausini_album)
haunted_heart_(sammy_kershaw_album)	haunted_heart_(sammy_kershaw_album)
andrew!!!	andrew!!!
erdentempel	erdentempel
dreamtime_(the_cult_album)	dreamtime_(the_cult_album)
catch_me_if_you_can_(soundtrack)	catch_me_if_you_can_(soundtrack)
shooting_rubberbands_at_the_stars	shooting_rubberbands_at_the_stars
everybody_knows_johnny_hodges	everybody_knows_johnny_hodges
pink_blossom	pink_blossom
playing_the_fool	playing_the_fool
take_me_to_your_leader_(hawkwind_album)	take_me_to_your_leader_(hawkwind_album)
'gator_tails	'gator_tails
wire_&_glass	wire_&_glass
strange_desire	strange_desire
the_hermetic_organ_vol._2	the_hermetic_organ_vol._2
smile_(the_beach_boys_album)	smiley_smile
the_clones_of_dr._funkenstein	the_clones_of_dr._funkenstein
from_the_front_row_..._live!	from_the_front_row_..._live!
paris_concert_(keith_jarrett_album)	paris_concert_(keith_jarrett_album)
tactical	tactical
apt._13	apt._13
ultimate_collection_(the_fixx_album)	1011_woodland
requiem_(the_autumn_offering_album)	requiem_(the_autumn_offering_album)
load_(album)	load_(album)
the_very_best_of_john_michael_montgomery	the_very_best_of_john_michael_montgomery
courage_(fish_leong_album)	courage_(fish_leong_album)
rebel-revive	rebel-revive
the_kink_kontroversy	the_kink_kontroversy
marinella_(1971_album)	sti_skini
happenings_(bobby_hutcherson_album)	happenings_(bobby_hutcherson_album)
thrak	thrak
send_the_fire	send_the_fire
until_the_colours_run	until_the_colours_run
buzz_or_howl_under_the_influence_of_heat	buzz_or_howl_under_the_influence_of_heat
well_respected_kinks	well_respected_kinks
never_sold_out_2	never_sold_out_2
no_more_tears	no_more_tears
the_triumph_of_steel	the_triumph_of_steel
goodbye_flatland	goodbye_flatland
restrictions_(album)	restrictions_(album)
nights_of_ballads_&_blues	nights_of_ballads_&_blues
let_the_hustlers_play	let_the_hustlers_play
fifth_dimension_(album)	fifth_dimension_(album)
carrying_your_love_with_me	carrying_your_love_with_me
the_frenz_experiment	the_frenz_experiment
bloody_tourists	bloody_tourists
the_very_best_of_daryl_hall_&_john_oates	the_very_best_of_daryl_hall_&_john_oates
hangable_auto_bulb	hangable_auto_bulb
pure_instinct	pure_instinct
two_souls_in_one	two_souls_in_one
shock'n_y'all	shock'n_y'all
sparkle_(aretha_franklin_album)	sparkle_(aretha_franklin_album)
isolation_(toto_album)	isolation_(toto_album)
welcome_to_the_canteen	welcome_to_the_canteen
teeth_dreams	teeth_dreams
the_feelin's_good	the_feelin's_good
get_up_on_it	get_up_on_it
return_of_crystal_karma	return_of_crystal_karma
ukonhauta	ukonhauta
live_in_tokyo_(public_image_limited_album)	live_in_tokyo_(public_image_limited_album)
live_at_carnegie_hall_(stevie_ray_vaughan_album)	live_at_carnegie_hall_(stevie_ray_vaughan_album)
mtv_unplugged_(alejandro_sanz_album)	mtv_unplugged_(alejandro_sanz_album)
work_resumed_on_the_tower	work_resumed_on_the_tower
spaced_out_in_london	spaced_out_in_london
the_roaring_silence	the_roaring_silence
no_world_order	no_world_order
the_fucking_cunts_treat_us_like_pricks	the_fucking_cunts_treat_us_like_pricks
shoutin'	shoutin'
hot_&_slow	hot_&_slow
all_things_new_(steven_curtis_chapman_album)	all_things_new_(steven_curtis_chapman_album)
four_altos	four_altos
eimai	eimai
life_as_a_dog	life_as_a_dog
lush_life_(linda_ronstadt_album)	lush_life_(linda_ronstadt_album)
body_talk_(the_wallets_album)	body_talk_(the_wallets_album)
thankful_(caedmon's_call_album)	thankful_(caedmon's_call_album)
lonely_road_(the_red_jumpsuit_apparatus_album)	lonely_road_(the_red_jumpsuit_apparatus_album)
live_(ufo_album)	live_(ufo_album)
greatest_hits_3_(tim_mcgraw_album)	greatest_hits_3_(tim_mcgraw_album)
beat_the_boots	beat_the_boots
beatles_vi	beatles_vi
beast_from_the_east	beast_from_the_east
stand_(michael_w._smith_album)	stand_(michael_w._smith_album)
shallow_life	shallow_life
anevaines	anevaines
george_strait_(album)	george_strait_(album)
strait_from_the_heart	strait_from_the_heart
karkelo	karkelo
take_it_off_(album)	take_it_off_(album)
tha_miliso_me_t'asteria	tha_miliso_me_t'asteria
ming's_samba	ming's_samba
hold_time_(album)	hold_time_(album)
the_best_of_tracy_lawrence	the_best_of_tracy_lawrence
backwards_chimney	backwards_chimney
a_whole_new_thing_(billy_preston_album)	a_whole_new_thing_(billy_preston_album)
living_in_oz	living_in_oz
tijuana_moods	tijuana_moods
loopified	loopified
a_fresh_aire_christmas	a_fresh_aire_christmas
there's_no_666_in_outer_space	there's_no_666_in_outer_space
christmas_(rebecca_st._james_album)	christmas_(rebecca_st._james_album)
it's_got_to_be_now	it's_got_to_be_now
a_bit_of_liverpool	a_bit_of_liverpool
oasis_(roberta_flack_album)	oasis_(roberta_flack_album)
heavy_metal_kings_(album)	heavy_metal_kings_(album)
the_faces_i've_been	the_faces_i've_been
rivers_in_the_wasteland	rivers_in_the_wasteland
kind_of_love	kind_of_love
diamond_in_the_firepit	diamond_in_the_firepit
laura_pausini_(1993_album)	laura_pausini_(1993_album)
nikki_nack	nikki_nack
an_innocent_man	an_innocent_man
the_melancholy_e.p.	the_melancholy_e.p.
the_human_contradiction	the_human_contradiction
little_little	little_little
you're_under_arrest_(miles_davis_album)	you're_under_arrest_(miles_davis_album)
herd_runners	herd_runners
paraksenes_eikones	paraksenes_eikones
feel.love.thinking.of	feel.love.thinking.of
the_hard_way_(clint_black_album)	the_hard_way_(clint_black_album)
infinite_(eminem_album)	slim_shady_ep
red_trigger_(aka_no_yuuhatsu_omoi_douki)	red_trigger_(aka_no_yuuhatsu_omoi_douki)
the_majesty_of_the_blues	the_majesty_of_the_blues
expectations_(keith_jarrett_album)	expectations_(keith_jarrett_album)
if_i_were_brittania_i'd_waive_the_rules	if_i_were_brittania_i'd_waive_the_rules
on_moonlight_bay_(album)	on_moonlight_bay_(album)
1_fille_&_4_types	1_fille_&_4_types
50_number_ones	50_number_ones
200_million_thousand	200_million_thousand
gods_of_war_(manowar_album)	gods_of_war_(manowar_album)
the_weavers_at_carnegie_hall	the_weavers_at_carnegie_hall
yelove	yelove
a_new_tide	a_new_tide
amore_(andrea_bocelli_album)	amore_(andrea_bocelli_album)
point_blank_(bonfire_album)	point_blank_(bonfire_album)
murmur_(album)	murmur_(album)
rise_of_the_lion	rise_of_the_lion
thunder_live	thunder_live
christmas_(mannheim_steamroller_album)	christmas_(mannheim_steamroller_album)
perpetual_flame	perpetual_flame
parade_(prince_album)	parade_(prince_album)
live_at_montreux_2003	live_at_montreux_2003
metal_mad_man	metal_mad_man
embryonic	embryonic
do_it_for_love	do_it_for_love
akasha_gulva	akasha_gulva
evenin'_blues	evenin'_blues
the_weight_of_the_world_(metal_church_album)	the_weight_of_the_world_(metal_church_album)
man_on_the_rocks	man_on_the_rocks
roberta_flack_(album)	roberta_flack_(album)
and_then_nothing_turned_itself_inside-out	and_then_nothing_turned_itself_inside-out
tapping_the_vein_(album)	tapping_the_vein_(album)
wunderboy	wunderboy
the_quantum_enigma	the_quantum_enigma
the_powers_that_b	the_powers_that_b
the_hits_collection_(kim_wilde_album)	the_hits_collection_(kim_wilde_album)
flag_(yello_album)	flag_(yello_album)
real_people_(album)	real_people_(album)
love,_god,_murder	love,_god,_murder
trio_64	trio_64
masquerade_(running_wild_album)	masquerade_(running_wild_album)
tra_te_e_il_mare	tra_te_e_il_mare
569_(album)	569_(album)
live_at_jacksonville	live_at_jacksonville
same_old_man	same_old_man
calamity_jane_(album)	calamity_jane_(album)
2nd_wind	2nd_wind
modern_jazz_trumpets	modern_jazz_trumpets
art_brut_vs._satan	art_brut_vs._satan
yellow_vector_(ki_no_taji_gen_shikousei)	yellow_vector_(ki_no_taji_gen_shikousei)
emergency_(kool_&_the_gang_album)	emergency_(kool_&_the_gang_album)
are_we_there	are_we_there
white_trash_with_money	white_trash_with_money
live_&_more_(roberta_flack_&_peabo_bryson_album)	live_&_more_(roberta_flack_&_peabo_bryson_album)
it's_alive_(ramones_album)	it's_alive_(ramones_album)
the_music_of_christmas	the_music_of_christmas
ways_&_means_(album)	ways_&_means_(album)
distant_satellites	distant_satellites
adicta	adicta
seven_steps_to_heaven	seven_steps_to_heaven
the_power_of_jennifer_rush	the_power_of_jennifer_rush
the_complete_tubular_bells	the_complete_tubular_bells
sun_sun	sun_sun
live_at_chelmsford_top_security_prison	live_at_chelmsford_top_security_prison
the_letting_go	the_letting_go
an_imaginary_country	an_imaginary_country
olias_of_sunhillow	olias_of_sunhillow
first_sensibility	first_sensibility
4_satin	4_satin
you_made_me_realise	you_made_me_realise
head_over_heels_(cocteau_twins_album)	head_over_heels_(cocteau_twins_album)
the_blitz_(krokus_album)	the_blitz_(krokus_album)
the_time_of_the_assassins	the_time_of_the_assassins
xpectation	xpectation
hotel_valentine	hotel_valentine
truth_be_told_(blues_traveler_album)	truth_be_told_(blues_traveler_album)
this_one's_for_basie	this_one's_for_basie
occupied_territories_(album)	occupied_territories_(album)
greatest_hits_volume_one_(toby_keith_album)	greatest_hits_volume_one_(toby_keith_album)
symmetry_in_black	symmetry_in_black
walkin'_the_razor's_edge	walkin'_the_razor's_edge
style_(namie_amuro_album)	style_(namie_amuro_album)
a_new_day..._live_in_las_vegas	a_new_day..._live_in_las_vegas
borderline_(brooks_&_dunn_album)	borderline_(brooks_&_dunn_album)
who_else!	who_else!
steers_&_stripes	steers_&_stripes
redeemer_of_souls	redeemer_of_souls
baby_it's_me	baby_it's_me
revival_(reverend_horton_heat_album)	revival_(reverend_horton_heat_album)
between_the_buttons	between_the_buttons
best_the_back_horn	best_the_back_horn
le_chemin_(emmanuel_moire_album)	le_chemin_(emmanuel_moire_album)
the_uninvited_(soundtrack)	the_uninvited_(soundtrack)
bug_(dinosaur_jr._album)	bug_(dinosaur_jr._album)
in_person_at_carnegie_hall	in_person_at_carnegie_hall
the_great_adventure_(album)	the_great_adventure_(album)
live_at_wacken_open_air_2006	live_at_wacken_open_air_2006
blame_it_on_gravity	blame_it_on_gravity
erota,_den_ksereis_n'agapas	erota,_den_ksereis_n'agapas
all_hell_breaks_loose_(destruction_album)	all_hell_breaks_loose_(destruction_album)
fight_the_silence	fight_the_silence
the_fabulous_little_richard	the_fabulous_little_richard
when_somebody_loves_you_(album)	when_somebody_loves_you_(album)
tales_from_the_strip	tales_from_the_strip
crusader_(chris_de_burgh_album)	crusader_(chris_de_burgh_album)
bridge_(blues_traveler_album)	bridge_(blues_traveler_album)
cavalier_youth	cavalier_youth
the_unforgettable_fire	the_unforgettable_fire
under_the_influence_(alan_jackson_album)	under_the_influence_(alan_jackson_album)
the_first_christmas_(album)	the_first_christmas_(album)
here_at_the_mayflower	here_at_the_mayflower
it's_about_time_(john_denver_album)	it's_about_time_(john_denver_album)
nil_(album)	nil_(album)
the_art_of_control	the_art_of_control
'til_shiloh	'til_shiloh
astral_weeks_live_at_the_hollywood_bowl	astral_weeks_live_at_the_hollywood_bowl
mortal_way_of_live	mortal_way_of_live
michael_clayton_(soundtrack)	michael_clayton_(soundtrack)
it's_album_time	it's_album_time
phosphorescent_harvest	phosphorescent_harvest
4x4_(casiopea_album)	4x4_(casiopea_album)
the_earth_pressed_flat	the_earth_pressed_flat
cannonball_adderley_live!	cannonball_adderley_live!
heart_strings_(moya_brennan_album)	heart_strings_(moya_brennan_album)
let's_do_it_for_johnny!	let's_do_it_for_johnny!
world_record_(van_der_graaf_generator_album)	world_record_(van_der_graaf_generator_album)
special_herbs,_vols._4,_5_&_6	special_herbs,_vols._4,_5_&_6
kyliex2008_(video)	kyliex2008_(video)
berserker_(gary_numan_album)	berserker_(gary_numan_album)
photographs_(casiopea_album)	photographs_(casiopea_album)
far_beyond_these_castle_walls	far_beyond_these_castle_walls
folksongs_for_a_nuclear_village	folksongs_for_a_nuclear_village
night_dreamer	night_dreamer
spiritual_unity	spiritual_unity
poland_(album)	poland_(album)
ctrl_alt_delete_(album)	ctrl_alt_delete_(album)
the_beat_of_my_heart	the_beat_of_my_heart
long_cold_winter	long_cold_winter
start_(album)	start_(album)
wasted_(l.a._guns_ep)	wasted_(l.a._guns_ep)
live_in_london_(april_wine_video)	live_in_london_(april_wine_video)
mad_thad	mad_thad
day_for_night_(the_tragically_hip_album)	day_for_night_(the_tragically_hip_album)
paradoxa_paradoxa	paradoxa_paradoxa
joya_(album)	joya_(album)
another_live	another_live
the_essential_blood,_sweat_&_tears	the_essential_blood,_sweat_&_tears
emmones_idees	emmones_idees
the_happy_horns_of_clark_terry	the_happy_horns_of_clark_terry
islands_(mike_oldfield_album)	islands_(mike_oldfield_album)
best_of_go!go!	best_of_go!go!
flowers_for_algernon_(album)	flowers_for_algernon_(album)
delightfulee_morgan	delightfulee_morgan
slow_dazzle_(album)	slow_dazzle_(album)
heart_attack_(krokus_album)	heart_attack_(krokus_album)
satori_(flower_travellin'_band_album)	satori_(flower_travellin'_band_album)
eagles_live	eagles_live
the_good_youth	the_good_youth
sweetheart_2014	sweetheart_2014
too_true	too_true
os_ekei_pou_i_kardia_bori_n'andexi	os_ekei_pou_i_kardia_bori_n'andexi
sin_sex_&_salvation	sin_sex_&_salvation
still_crazy_after_all_these_years	still_crazy_after_all_these_years
now_+_4eva	now_+_4eva
greatest_hits_(1996_john_anderson_album)	greatest_hits_(1996_john_anderson_album)
death_or_glory_(album)	death_or_glory_(album)
the_beatles'_story	the_beatles'_story
my_pride	my_pride
everything_will_be_alright_in_the_end	everything_will_be_alright_in_the_end
miracle_(celine_dion_album)	miracle_(celine_dion_album)
alien_3_(soundtrack)	alien_3_(soundtrack)
big_bam_boom	big_bam_boom
stanley_road	stanley_road
the_hits_chapter_2	the_hits_chapter_2
love_songs_for_the_retarded	love_songs_for_the_retarded
nin9_2_5ive	nin9_2_5ive
in_search_of_space	in_search_of_space
this_present_wasteland	this_present_wasteland
sweet_disarray	sweet_disarray
back_in_the_u.s.	back_in_the_u.s.
the_new_boss_guitar_of_george_benson	the_new_boss_guitar_of_george_benson
barry_manilow_ii	barry_manilow_ii
amoeba's_secret	amoeba's_secret
the_moment_(stefanie_sun_album)	the_moment_(stefanie_sun_album)
the_duke_plays_ellington	the_duke_plays_ellington
roughly_speaking	roughly_speaking
casiopea_world_live_'88	casiopea_world_live_'88
the_long_voyage_home_(album)	the_long_voyage_home_(album)
total_strife_forever	total_strife_forever
birks'_works	birks'_works
victory_(the_jacksons_album)	victory_(the_jacksons_album)
dunes_(album)	dunes_(album)
birth_of_the_cool	birth_of_the_cool
ordinary_riches	ordinary_riches
along_came_john	along_came_john
weezer_(2008_album)	christmas_with_weezer
10,000_towns	10,000_towns
evergreen_everblue	evergreen_everblue
just_another_band_from_l.a.	just_another_band_from_l.a.
liberal_animation	liberal_animation
first_underground_nuclear_kitchen	first_underground_nuclear_kitchen
sacred_heart_"the_video"	sacred_heart_"the_video"
workin'_out!	workin'_out!
latest_greatest_straitest_hits	latest_greatest_straitest_hits
mama,_i'm_swollen	mama,_i'm_swollen
open_mind_(album)	open_mind_(album)
greatest_hits_volume_ii_(alan_jackson_album)	greatest_hits_volume_ii_(alan_jackson_album)
the_sixth_sense_(lee_morgan_album)	the_sixth_sense_(lee_morgan_album)
signature_(moya_brennan_album)	signature_(moya_brennan_album)
kindly_bent_to_free_us	kindly_bent_to_free_us
long_time..._seldom_scene	long_time..._seldom_scene
futuristic_dragon	futuristic_dragon
trashed,_lost_&_strungout	trashed,_lost_&_strungout
antidoto	antidoto
in_conflict	in_conflict
brooklynati	brooklynati
no_room_for_squares	no_room_for_squares
not_a_moment_too_soon	not_a_moment_too_soon
casualties_of_cool	casualties_of_cool
drinking_with_jesus	drinking_with_jesus
one_step_at_a_time_(george_strait_album)	one_step_at_a_time_(george_strait_album)
manilow_sings_sinatra	manilow_sings_sinatra
greatest_hits_volume_two_(george_strait_album)	greatest_hits_volume_two_(george_strait_album)
save_his_soul	save_his_soul
punishment_in_capitals	punishment_in_capitals
singin'_with_the_big_bands	singin'_with_the_big_bands
genius_+_love_=_yo_la_tengo	genius_+_love_=_yo_la_tengo
jesus_christ_superstars	jesus_christ_superstars
the_best_of_rare_cult	the_best_of_rare_cult
this_girl's_in_love_with_you	this_girl's_in_love_with_you
hitorigei_3	hitorigei_3
hergest_ridge_(album)	hergest_ridge_(album)
here_in_the_real_world	here_in_the_real_world
bbc_radio_1_live_in_concert_(hawkwind_album)	bbc_radio_1_live_in_concert_(hawkwind_album)
transit_transit	transit_transit
mingus_three	mingus_three
thrash_anthems	thrash_anthems
live_dilute_&_hella_split	live_dilute_&_hella_split
a_letter_home	a_letter_home
allroy_saves	allroy_saves
count_on_my_love	count_on_my_love
the_best_in_town	the_best_in_town
slaves_of_the_world	slaves_of_the_world
a_night_in_san_francisco	a_night_in_san_francisco
real_life_conversations	real_life_conversations
stamina_daddy	stamina_daddy
little_boots_(ep)	little_boots_(ep)
je_te_dis_vous	je_te_dis_vous
trooper_(album)	trooper_(album)
the_cautionary_tales_of_mark_oliver_everett	the_cautionary_tales_of_mark_oliver_everett
some_people's_lives	some_people's_lives
habeas_corpus_(album)	habeas_corpus_(album)
david_byrne_live_at_union_chapel	david_byrne_live_at_union_chapel
lawyers_in_love	lawyers_in_love
freak_magnet	freak_magnet
greatest_hits_live_1997	greatest_hits_live_1997
hey_stoopid	hey_stoopid
the_rocking_tenor_sax_of_eddie_chamblee	the_rocking_tenor_sax_of_eddie_chamblee
smiley_smile	smiley_smile
out_among_the_stars	out_among_the_stars
virgin_killer	virgin_killer
the_bad_&_the_better	the_bad_&_the_better
maybe_not_tonight	maybe_not_tonight
surfing_on_sine_waves	surfing_on_sine_waves
fully_completely	fully_completely
below_paradise	below_paradise
back_to_time_(complete_emi_years)	back_to_time_(complete_emi_years)
one_for_the_road_(the_kinks_album)	one_for_the_road_(the_kinks_album)
good_guys_(album)	good_guys_(album)
live!_(anna_vissi_album)	live!_(anna_vissi_album)
straight_on_till_morning_(album)	straight_on_till_morning_(album)
carry_us_now	carry_us_now
notorious_(soundtrack)	notorious_(soundtrack)
strange_highways	strange_highways
thizzelle_washington	thizzelle_washington
the_best_band_you_never_heard_in_your_life	the_best_band_you_never_heard_in_your_life
the_greatest_songs_of_the_eighties	the_greatest_songs_of_the_eighties
let_the_ocean_take_me	let_the_ocean_take_me
as_is_now	as_is_now
oohs_&_aahs	oohs_&_aahs
1011_woodland	1011_woodland
anvil_vapre	anvil_vapre
a_beautiful_mind_(soundtrack)	a_beautiful_mind_(soundtrack)
i_blow_minds_for_a_living	i_blow_minds_for_a_living
live_in_japan_(john_coltrane_album)	live_in_japan_(john_coltrane_album)
drukqs	drukqs
the_road_less_traveled_(george_strait_album)	the_road_less_traveled_(george_strait_album)
my_love_is_a_bulldozer	my_love_is_a_bulldozer
nato_(album)	nato_(album)
slow_turning	slow_turning
soutak	soutak
the_full-custom_gospel_sounds_of_the_reverend_horton_heat	the_full-custom_gospel_sounds_of_the_reverend_horton_heat
9_dead_alive	9_dead_alive
rising_force	rising_force
harem_scarem_(album)	harem_scarem_(album)
i_can_wonder_what_you_did_with_your_day	i_can_wonder_what_you_did_with_your_day
hell_on_stage	hell_on_stage
doro_theou	doro_theou
rock_city_vs_the_wildhearts	rock_city_vs_the_wildhearts
controversy_(prince_album)	controversy_(prince_album)
duke_pandemonium	duke_pandemonium
god_won't_give_up	god_won't_give_up
face_the_heat	face_the_heat
zig_zag_(the_hooters_album)	zig_zag_(the_hooters_album)
the_greatest_songs_of_the_sixties	the_greatest_songs_of_the_sixties
enemy_mine_(album)	enemy_mine_(album)
for_certain_because	for_certain_because
the_hoople	the_hoople
out_of_control_(ted_nugent_album)	out_of_control_(ted_nugent_album)
octopus_(gentle_giant_album)	octopus_(gentle_giant_album)
c'est_chic	c'est_chic
classicks	classicks
big_dog_daddy	big_dog_daddy
martina_(album)	martina_(album)
stephen_stills_2	stephen_stills_2
on_the_road_(george_carlin_album)	on_the_road_(george_carlin_album)
my_desired_happiness	my_desired_happiness
whisper_house	whisper_house
songs_for_sunday_evening	songs_for_sunday_evening
wild_&_blue	wild_&_blue
the_dub_room_special_(soundtrack)	the_dub_room_special_(soundtrack)
building_the_machine	building_the_machine
lo-fantasy	lo-fantasy
victory_(running_wild_album)	victory_(running_wild_album)
welcome_to_the_new	welcome_to_the_new
best_of_little_walter	best_of_little_walter
aretha_in_paris	aretha_in_paris
scarred_(album)	scarred_(album)
sonny_rollins,_vol._2	sonny_rollins,_vol._2
marching_out	marching_out
love_him_(album)	love_him_(album)
little_barefoot_soul	little_barefoot_soul
aikea-guinea	aikea-guinea
greatest_hits_(mark_chesnutt_album)	greatest_hits_(mark_chesnutt_album)
another_stoney_evening	another_stoney_evening
live_in_paris_05	live_in_paris_05
building_the_perfect_beast	building_the_perfect_beast
finnegan_wakes	finnegan_wakes
collection_(mike_oldfield_album)	collection_(mike_oldfield_album)
towards_the_sinister	towards_the_sinister
the_ultimate_luther_vandross	the_ultimate_luther_vandross
mo'_rock	mo'_rock
sleepless_nights_(patty_loveless_album)	sleepless_nights_(patty_loveless_album)
a_blowin'_session	a_blowin'_session
2_of_one	2_of_one
chaos_ridden_years	chaos_ridden_years
newk's_time	newk's_time
so_unreal	so_unreal
broadway_the_hard_way	broadway_the_hard_way
live_between_us	live_between_us
state_of_emergency_(steel_pulse_album)	state_of_emergency_(steel_pulse_album)
strange_blues	strange_blues
credo_(jennifer_rush_album)	credo_(jennifer_rush_album)
dream_walkin'	dream_walkin'
chikara_(album)	chikara_(album)
greatest_hits_(jewel_album)	greatest_hits_(jewel_album)
cursing_the_sea	cursing_the_sea
lucky_four_(album)	lucky_four_(album)
vancouver_(album)	vancouver_(album)
intermission_(dio_album)	intermission_(dio_album)
mingus_mingus_mingus_mingus_mingus	mingus_mingus_mingus_mingus_mingus
we_get_requests	we_get_requests
warriors_of_the_world	warriors_of_the_world
head_or_heart	head_or_heart
dainihon_itangeishateki_noumiso_gyaku_kaiten_zekkyou_ongenshuu	dainihon_itangeishateki_noumiso_gyaku_kaiten_zekkyou_ongenshuu
belly_of_the_sun	belly_of_the_sun
no_sick_days	no_sick_days
no_doubt_(petra_album)	no_doubt_(petra_album)
banana_wind	banana_wind
stronger_than_pride	stronger_than_pride
trinka_trinka	trinka_trinka
strange_friend	strange_friend
tales_of_kidd_funkadelic	tales_of_kidd_funkadelic
love_power_peace	love_power_peace
attics_to_eden	attics_to_eden
meet_the_vamps	meet_the_vamps
i'll_lead_you_home	i'll_lead_you_home
wanderlusting	wanderlusting
frigate_(album)	frigate_(album)
park_avenue_sound	park_avenue_sound
knock_'em_dead_kid	knock_'em_dead_kid
waking_up_with_the_house_on_fire	waking_up_with_the_house_on_fire
wreck_your_life	wreck_your_life
del_doc_&_mac	del_doc_&_mac
watermark_(enya_album)	watermark_(enya_album)
out_of_the_silent_planet_(album)	out_of_the_silent_planet_(album)
el_alma_al_aire	mtv_unplugged_(alejandro_sanz_album)
youth_society_(s.h.e_album)	youth_society_(s.h.e_album)
southsiders	southsiders
plagues_of_babylon	plagues_of_babylon
live_at_the_london_palladium	live_at_the_london_palladium
blondie_4(0)_ever	blondie_4(0)_ever
demolicious	demolicious
i_don't_want_to_miss_a_thing_(album)	i_don't_want_to_miss_a_thing_(album)
slade_alive!	slade_alive!
cold_spring_harbor_(album)	cold_spring_harbor_(album)
blue_haze	blue_haze
costello_&_nieve	costello_&_nieve
mixes_(kylie_minogue_album)	mixes_(kylie_minogue_album)
to_love_(faye_wong_album)	to_love_(faye_wong_album)
sodom_(album)	sodom_(album)
the_word_is_live	the_word_is_live
night_of_the_stormrider	night_of_the_stormrider
no_education_=_no_future_(fuck_the_curfew)	no_education_=_no_future_(fuck_the_curfew)
the_nature_of_the_beast_(album)	the_nature_of_the_beast_(album)
space_ritual	space_ritual
the_peel_sessions_(echo_&_the_bunnymen_ep)	the_peel_sessions_(echo_&_the_bunnymen_ep)
john_jenkins_with_kenny_burrell	john_jenkins_with_kenny_burrell
hell_on_wheels_(album)	hell_on_wheels_(album)
fopp_(ep)	fopp_(ep)
oscar_peterson_at_the_concertgebouw	oscar_peterson_at_the_concertgebouw
rock_on_honorable_ones!!	bowling_for_soup_goes_to_the_movies
archie_shepp_&_the_new_york_contemporary_five	archie_shepp_&_the_new_york_contemporary_five
lead_on	lead_on
chic_(album)	chic_(album)
the_singles_collection_(the_specials_album)	the_singles_collection_(the_specials_album)
love_vs._money	love_vs._money
to_kati	to_kati
the_thin_red_line_(soundtrack)	the_thin_red_line_(soundtrack)
direct_(vangelis_album)	direct_(vangelis_album)
with_a_little_help_from_my_fwends	with_a_little_help_from_my_fwends
cichlisuite	cichlisuite
selected_ambient_works_volume_ii	selected_ambient_works_volume_ii
this_moment_(album)	this_moment_(album)
drivetrain_(album)	drivetrain_(album)
sonny_clark_quintets	sonny_clark_quintets
7_(george_strait_album)	7_(george_strait_album)
alive_in_athens	alive_in_athens
isolated_incident	isolated_incident
good_to_be_home	good_to_be_home
art_electric	art_electric
a_jolly_christmas_from_frank_sinatra	a_jolly_christmas_from_frank_sinatra
heavy_nova_(album)	heavy_nova_(album)
star_fleet_project	star_fleet_project
in_europe	in_europe
25th_anniversary_ultimate_best_-the_one-	25th_anniversary_ultimate_best_-the_one-
respect_yourself_(album)	respect_yourself_(album)
jeff_(album)	jeff_(album)
on_(ep)	on_(ep)
tipota_den_ginete_tihea	tipota_den_ginete_tihea
the_joy_of_motion	the_joy_of_motion
sleepwalker_(the_kinks_album)	sleepwalker_(the_kinks_album)
triumph_(triumph_album)	triumph_(triumph_album)
song_for_my_father	song_for_my_father
the_hooters_live	the_hooters_live
hold_me_in_your_arms_(album)	hold_me_in_your_arms_(album)
video_clips_(album)	video_clips_(album)
workers_playtime_(album)	workers_playtime_(album)
weed_money	weed_money
return_to_evermore	return_to_evermore
endless_harmony_soundtrack	endless_harmony_soundtrack
arab_quarter_(album)	arab_quarter_(album)
the_appearances_of_keak_da_sneak	the_appearances_of_keak_da_sneak
eyes_of_the_mind	eyes_of_the_mind
back_to_titanic	back_to_titanic
alive_&_kicking_(nana_mizuki_album)	alive_&_kicking_(nana_mizuki_album)
life_on_a_string_(album)	live_in_new_york_(laurie_anderson_album)
once_more_'round_the_sun	once_more_'round_the_sun
conversations_with_myself	conversations_with_myself
so_damn_happy_(loudon_wainwright_iii_album)	so_damn_happy_(loudon_wainwright_iii_album)
ego_(the_very_best_of_emi_years)	tipota_den_ginete_tihea
the_miskatonic_scale	the_miskatonic_scale
only_a_lad	skeletons_in_the_closet_(oingo_boingo_album)
beat_the_boots_ii	beat_the_boots_ii
gama_(album)	gama_(album)
the_golden_section	the_golden_section
it's_all_crazy!_it's_all_false!_it's_all_a_dream!_it's_alright	it's_all_crazy!_it's_all_false!_it's_all_a_dream!_it's_alright
regretfully_yours	regretfully_yours
blood_at_the_orpheum	blood_at_the_orpheum
reformation_1	reformation_1
greatest_hits_(tim_mcgraw_album)	greatest_hits_(tim_mcgraw_album)
day_by_night	day_by_night
nana_mizuki_live_fighter_-blue_x_red_side-	nana_mizuki_live_fighter_-blue_x_red_side-
miles_davis_with_sonny_rollins	miles_davis_with_sonny_rollins
hunt_music	hunt_music
st._anger	st._anger
disconnected_(fates_warning_album)	disconnected_(fates_warning_album)
crazy_world_(scorpions_album)	crazy_world_(scorpions_album)
deuce_(rory_gallagher_album)	deuce_(rory_gallagher_album)
the_pariah,_the_parrot,_the_delusion	the_pariah,_the_parrot,_the_delusion
greatest_hits_live_2003	greatest_hits_live_2003
magica_(album)	magica_(album)
drive_me_wild	drive_me_wild
talk_is_cheap_vol_iii	talk_is_cheap_vol_iii
honky_tonk_attitude	honky_tonk_attitude
the_complete_live_in_japan	the_complete_live_in_japan
hot_rats	hot_rats
swass	swass
live_'84	live_'84
guitars_(mike_oldfield_album)	guitars_(mike_oldfield_album)
this_is_where_we_are	this_is_where_we_are
super_hits_(alan_jackson_album)	super_hits_(alan_jackson_album)
refugees_of_the_heart	refugees_of_the_heart
cloud_cock_oo_grand	cloud_cock_oo_grand
everything_almost	everything_almost
ikuiset_lapset	ikuiset_lapset
io_canto	io_canto
street_value	street_value
garage_inc.	garage_inc.
live_at_watkins_glen	live_at_watkins_glen
chameleon_(labelle_album)	chameleon_(labelle_album)
big_science_(laurie_anderson_album)	big_science_(laurie_anderson_album)
want_that_life	want_that_life
nippon_soul	nippon_soul
a_simple_matter_of_conviction	a_simple_matter_of_conviction
war_room_stories	war_room_stories
for_someone_i_love	for_someone_i_love
gulf_between_us	gulf_between_us
paul_chambers_quintet	paul_chambers_quintet
sings_greatest_palace_music	sings_greatest_palace_music
4_seasons_in_one_day	4_seasons_in_one_day
blues_&_roots	blues_&_roots
mingus_at_monterey	mingus_at_monterey
the_beatles'_second_album	the_beatles'_second_album
worship_god	worship_god
deified_(album)	deified_(album)
dancing_to_the_music_in_my_head	dancing_to_the_music_in_my_head
21st_fortune	21st_fortune
love_will_have_the_final_word	love_will_have_the_final_word
the_night_watch_(album)	the_night_watch_(album)
flowers_(echo_&_the_bunnymen_album)	flowers_(echo_&_the_bunnymen_album)
disney_channel_play_it_loud	disney_channel_play_it_loud
master_of_paradise	master_of_paradise
blitz_(album)	blitz_(album)
the_stylistics_(album)	the_stylistics_(album)
eternal_enemies	eternal_enemies
words_from_the_exit_wound	words_from_the_exit_wound
formula,_vol._2	formula,_vol._2
songs_from_the_capeman	songs_from_the_capeman
quiet_nights_(diana_krall_album)	quiet_nights_(diana_krall_album)
planet_roll_call	planet_roll_call
rips_the_covers_off	rips_the_covers_off
the_magazine_(album)	the_magazine_(album)
the_best_of_ricky_martin	la_historia_(ricky_martin_album)
with_the_beatles	with_the_beatles
the_zombie_horror_picture_show	the_zombie_horror_picture_show
zekkeishoku	zekkeishoku
joe's_menage	joe's_menage
death_comes_in_26_carefully_selected_pieces	death_comes_in_26_carefully_selected_pieces
songs_for_young_lovers	songs_for_young_lovers
evolution_(martina_mcbride_album)	evolution_(martina_mcbride_album)
18_hronia_live	18_hronia_live
into_the_light_(chris_de_burgh_album)	into_the_light_(chris_de_burgh_album)
empnefsi!	empnefsi!
rollin'_with_the_flow_(album)	rollin'_with_the_flow_(album)
fantasy_land_tour_2004_in_taipei	fantasy_land_tour_2004_in_taipei
the_andy_williams_christmas_album	the_andy_williams_christmas_album
the_dealers	the_dealers
drive_(alan_jackson_album)	drive_(alan_jackson_album)
wolf's_law	wolf's_law
mission_temple_fireworks_stand	mission_temple_fireworks_stand
disorder_(album)	disorder_(album)
diatribes_(album)	diatribes_(album)
age_of_reason_(album)	age_of_reason_(album)
follow_the_leader_(eric_b._&_rakim_album)	follow_the_leader_(eric_b._&_rakim_album)
free_(love)	free_(love)
featuring_pharoah_sanders_&_black_harold	featuring_pharoah_sanders_&_black_harold
reckoning_(r.e.m._album)	reckoning_(r.e.m._album)
talk_is_cheap_vol_i	talk_is_cheap_vol_i
if_evolution_is_outlawed,_only_outlaws_will_evolve	if_evolution_is_outlawed,_only_outlaws_will_evolve
copper_gone	copper_gone
tiny_pictures	tiny_pictures
extended_versions_(ted_nugent_album)	extended_versions_(ted_nugent_album)
you_had_it_coming	you_had_it_coming
special_herbs,_vol._2	special_herbs,_vol._2
santana_(1971_album)	santana_(1971_album)
special_herbs,_vol._4	special_herbs,_vol._4
music_of_the_final_fantasy_vii_series	music_of_the_final_fantasy_vii_series
yer_favourites	yer_favourites
the_blues_book	the_blues_book
live_on_broadway	live_on_broadway
road_between	road_between
around_the_well	around_the_well
truly_for_you	truly_for_you
those_were_the_hits	those_were_the_hits
crossing_the_rubicon_(the_sounds_album)	crossing_the_rubicon_(the_sounds_album)
walkin'	walkin'
tea_for_two_(album)	tea_for_two_(album)
hearty_notes	hearty_notes
guitar_(frank_zappa_album)	guitar_(frank_zappa_album)
paradize	paradize
primavera_in_anticipo	primavera_in_anticipo
crossing_muddy_waters	crossing_muddy_waters
joe_cocker_live	joe_cocker_live
night_visions_live	night_visions_live
now_that's_what_i_call_running_2014	now_that's_what_i_call_running_2014
everyday_robots	everyday_robots
hot_shots_(album)	hot_shots_(album)
juju_(album)	juju_(album)
no_mythologies_to_follow	no_mythologies_to_follow
exotic_creatures_of_the_deep	exotic_creatures_of_the_deep
live_in_italy_(lou_reed_album)	live_in_italy_(lou_reed_album)
perverted_by_language	perverted_by_language
shrinking_violet_(album)	shrinking_violet_(album)
all_directions	all_directions
gold_(scorpions_album)	gold_(scorpions_album)
mue	mue
music_of_final_fantasy_xi	music_of_final_fantasy_xi
live_in_concert_2006	live_in_concert_2006
dance_to_the_duke!	dance_to_the_duke!
love,_marriage_&_divorce	love,_marriage_&_divorce
stefanie_(album)	stefanie_(album)
yan_zi_(album)	yan_zi_(album)
order_of_the_leech	order_of_the_leech
pay_the_devil	pay_the_devil
the_sun_will_rise_again	the_sun_will_rise_again
the_gigolo	the_gigolo
roll_on_summer	roll_on_summer
aretha_(1980_album)	aretha_(1980_album)
ten_(trooper_album)	ten_(trooper_album)
i'm_not_your_suicide	i'm_not_your_suicide
ozzmosis	ozzmosis
live_at_fenway_park	live_at_fenway_park
retrohash	retrohash
music_of_final_fantasy_iii	music_of_final_fantasy_iii
music_of_final_fantasy_iii	music_of_final_fantasy_vi
greatest_hits,_vol._1_(doug_stone_album)	greatest_hits,_vol._1_(doug_stone_album)
ring_frei_(album)	ring_frei_(album)
jackpot!_the_best_bette	jackpot!_the_best_bette
alto_madness	alto_madness
dream_evil_(album)	dream_evil_(album)
life's_a_riot_with_spy_vs_spy	life's_a_riot_with_spy_vs_spy
my_story,_your_song	my_story,_your_song
acoustically_driven	acoustically_driven
diamonds_&_dirt	diamonds_&_dirt
untasted_honey	untasted_honey
alive_in_florida	alive_in_florida
death_by_manipulation	death_by_manipulation
beauty_&_ruin	beauty_&_ruin
east_broadway_run_down	east_broadway_run_down
genesis_of_2pm	genesis_of_2pm
the_ecstatic	the_ecstatic
empyrean_isles	empyrean_isles
do_to_the_beast	do_to_the_beast
odyssey_of_iska	odyssey_of_iska
let_it_go_(tim_mcgraw_album)	let_it_go_(tim_mcgraw_album)
rapture_(impaled_nazarene_album)	rapture_(impaled_nazarene_album)
kinksize_session	kinksize_session
this_is_niecy	this_is_niecy
wheelin'_&_dealin'	wheelin'_&_dealin'
arena_(todd_rundgren_album)	arena_(todd_rundgren_album)
space_heater_(album)	space_heater_(album)
second_sighting	second_sighting
the_sun,_moon_&_herbs	the_sun,_moon_&_herbs
greatest_hits_(john_michael_montgomery_album)	greatest_hits_(john_michael_montgomery_album)
music_of_final_fantasy_vi	music_of_final_fantasy_vi
concert_in_the_park	concert_in_the_park
kill_the_power	kill_the_power
jazz_impressions_of_japan	jazz_impressions_of_japan
keak_da_sneak_(album)	keak_da_sneak_(album)
the_last_temptation_(alice_cooper_album)	the_last_temptation_(alice_cooper_album)
strangeulation	strangeulation
django_(album)	django_(album)
lead_me_on_(amy_grant_album)	lead_me_on_(amy_grant_album)
bud!_the_amazing_bud_powell_(vol._3)	bud!_the_amazing_bud_powell_(vol._3)
the_doris_day_christmas_album	the_doris_day_christmas_album
a_flower_bookmark	a_flower_bookmark
untitled_trooper_album	untitled_trooper_album
invader_volume_1	invader_volume_1
serious_moonlight_(1983_film)	serious_moonlight_(1983_film)
greatest_hits_(martina_mcbride_album)	greatest_hits_(martina_mcbride_album)
merry_&_hell_go_round	merry_&_hell_go_round
genius_2000	genius_2000
apocalypto_(soundtrack)	apocalypto_(soundtrack)
beatlemania!_with_the_beatles	beatlemania!_with_the_beatles
magnum_opus_(yngwie_malmsteen_album)	magnum_opus_(yngwie_malmsteen_album)
i_want_my_money_back	i_want_my_money_back
quoth_(ep)	quoth_(ep)
on_the_road_to_kingdom_come	on_the_road_to_kingdom_come
slang_prostitution	slang_prostitution
if_you_ain't_lovin'_you_ain't_livin'	if_you_ain't_lovin'_you_ain't_livin'
down_upbeat	down_upbeat
with_everything_i_feel_in_me	with_everything_i_feel_in_me
solemn_on_stage	solemn_on_stage
bohemia_after_dark	bohemia_after_dark
urfe	urfe
exultation!	exultation!
blazon_stone	blazon_stone
tom_cat_(album)	tom_cat_(album)
honky_tonk_boots	honky_tonk_boots
intimate_portrait	intimate_portrait
29_golden_bullets	29_golden_bullets
the_party_(casiopea_album)	the_party_(casiopea_album)
leave_(album)	leave_(album)
aliens_(soundtrack)	aliens_(soundtrack)
sturm_&_drang_tour_2002	sturm_&_drang_tour_2002
wat_(album)	wat_(album)
son_of_a_preacher_man_(album)	son_of_a_preacher_man_(album)
animalize_live_uncensored	animalize_live_uncensored
live_from_austin,_tx_(john_hiatt_album)	live_from_austin,_tx_(john_hiatt_album)
the_complete_columbia_recordings_of_miles_davis_with_john_coltrane	the_complete_columbia_recordings_of_miles_davis_with_john_coltrane
4minute_world	4minute_world
rough_house_(album)	rough_house_(album)
everywhere_(tim_mcgraw_album)	everywhere_(tim_mcgraw_album)
no_rest_for_the_wicked_(ozzy_osbourne_album)	no_rest_for_the_wicked_(ozzy_osbourne_album)
unit_structures	unit_structures
you_(aretha_franklin_album)	you_(aretha_franklin_album)
sunshine_&_whiskey	sunshine_&_whiskey
you'll_never_walk_alone_(elvis_presley_album)	you'll_never_walk_alone_(elvis_presley_album)
re!	re!
heartwork	heartwork
one_voice_(barry_manilow_album)	one_voice_(barry_manilow_album)
one_voice_(barry_manilow_album)	manilow_sings_sinatra
all_day_long	all_day_long
the_procrastinator	the_procrastinator
infinity_(lee_morgan_album)	infinity_(lee_morgan_album)
icon_(icon_album)	icon_(icon_album)
surf_goddess	surf_goddess
me,_i'm_all_smiles	me,_i'm_all_smiles
gil_evans_&_ten	gil_evans_&_ten
middle_cyclone	middle_cyclone
michael_collins_(soundtrack)	michael_collins_(soundtrack)
a_special_from_the_spectrum	a_special_from_the_spectrum
burn_the_maps	burn_the_maps
lullabies_(ep)	lullabies_(ep)
five_live_yardbirds	five_live_yardbirds
donker_mag	donker_mag
live_in_concert_(martina_mcbride_album)	shine_(martina_mcbride_album)
catalogue_2005	catalogue_2005
the_greatest_hits_collection_(brooks_&_dunn_album)	the_greatest_hits_collection_(brooks_&_dunn_album)
subconscious-lee	subconscious-lee
strictly_personal	strictly_personal
rock_action_(album)	rock_action_(album)
silknoose	silknoose
living_ornaments_'81	living_ornaments_'81
the_way_that_i_am	the_way_that_i_am
hitchhike_to_rhome	hitchhike_to_rhome
jazz_mood	jazz_mood
please_return_the_evening	please_return_the_evening
martika_(album)	martika_(album)
if_you_see_her	if_you_see_her
roberta_flack_&_donny_hathaway	roberta_flack_&_donny_hathaway
rain_effect	rain_effect
inspirato	inspirato
by_absence_of_the_sun	by_absence_of_the_sun
first_love_(emmy_the_great_album)	first_love_(emmy_the_great_album)
m-16_(album)	m-16_(album)
tim_mcgraw_(album)	tim_mcgraw_(album)
crash_love	crash_love
bark_at_the_moon	bark_at_the_moon
jennifer_rush_(1984_album)	jennifer_rush_(1984_album)
violet_meme_(murasaki_no_jyouhoudentatsu_chi)	violet_meme_(murasaki_no_jyouhoudentatsu_chi)
get_what_you_deserve	get_what_you_deserve
only_what_i_feel	only_what_i_feel
animal_magnetism_(merzbow_album)	animal_magnetism_(merzbow_album)
live_in_europe_(creedence_clearwater_revival_album)	live_in_europe_(creedence_clearwater_revival_album)
across_the_earth	across_the_earth
nine_lives_(steve_winwood_album)	nine_lives_(steve_winwood_album)
freak_out!	freak_out!
a_place_in_the_sun_(tim_mcgraw_album)	a_place_in_the_sun_(tim_mcgraw_album)
double_live!	double_live!
sola_scriptura_(album)	sola_scriptura_(album)
mingus_ah_um	mingus_ah_um
slaughterhouse_on_the_prairie	slaughterhouse_on_the_prairie
neei	neei
one_acoustic_night	one_acoustic_night
the_great_gildo	the_great_gildo
red_dirt_road	red_dirt_road
hotel_california_(eagles_album)	hotel_california_(eagles_album)
lee-way	lee-way
america,_i_hear_you_singing	america,_i_hear_you_singing
after_the_disco	after_the_disco
conquering_ruler	conquering_ruler
the_boys_are_back_(sawyer_brown_album)	the_boys_are_back_(sawyer_brown_album)
the_hawk_is_howling	the_hawk_is_howling
kraftwerk_2	kraftwerk_2
bad_self_portraits	bad_self_portraits
beauty_stab	beauty_stab
born_to_love	born_to_love
native_dancer_(album)	native_dancer_(album)
john_scofield_live	john_scofield_live
set_this_circus_down	set_this_circus_down
the_pajama_game_(album)	the_pajama_game_(album)
go_bo_diddley	go_bo_diddley
flying_colors_(trooper_album)	flying_colors_(trooper_album)
safety_(ep)	safety_(ep)
lincoln_(album)	lincoln_(album)
checkmate_savage	checkmate_savage
the_coats_of_claude	the_coats_of_claude
inside_the_torn_apart	inside_the_torn_apart
super_hits_(brooks_&_dunn_album)	super_hits_(brooks_&_dunn_album)
narcotic_(album)	narcotic_(album)
jennifer_rush_(1992_album)	jennifer_rush_(1992_album)
decline_&_fall	decline_&_fall
feels_like_comin'_home	feels_like_comin'_home
time_(mercyful_fate_album)	the_bell_witch_(ep)
fading_west	fading_west
ray_charles_(album)	ray_charles_(album)
strange_weirdos	strange_weirdos
eve_(the_alan_parsons_project_album)	the_turn_of_a_friendly_card
san_siro_2007	san_siro_2007
dissect,_molest,_ingest	dissect,_molest,_ingest
built_on_glass	built_on_glass
put_your_needle_down	put_your_needle_down
we_are_the_broken	we_are_the_broken
all_(all_album)	all_(all_album)
day_by_day_(doris_day_album)	day_by_day_(doris_day_album)
bermuda_waterfall	bermuda_waterfall
baby,_baby,_baby	baby,_baby,_baby
ep7	ep7
kiss_me_once	kiss_me_once
she's_so_unusual	she's_so_unusual
batman_begins_(soundtrack)	batman_begins_(soundtrack)
tryin'_to_get_the_feeling	tryin'_to_get_the_feeling
live_noumatrouff,_1997	live_noumatrouff,_1997
rancho_alto	rancho_alto
lock_up_the_wolves	lock_up_the_wolves
good_singin',_good_playin'	good_singin',_good_playin'
drive_(robert_palmer_album)	drive_(robert_palmer_album)
the_word_from_mose	the_word_from_mose
high_hopes_&_heartbreak	high_hopes_&_heartbreak
play_(s.h.e_album)	play_(s.h.e_album)
a_war_of_our_own	a_war_of_our_own
the_who_by_numbers	the_who_by_numbers
the_video_collection_(anna_vissi_video)	the_video_collection_(anna_vissi_video)
live_at_hammersmith_'79	live_at_hammersmith_'79
chet_baker_&_strings	chet_baker_&_strings
s&m_(metallica_album)	s&m_(metallica_album)
mogwai_young_team	mogwai_young_team
young_boy_blues	young_boy_blues
in_dreams_(soundtrack)	in_dreams_(soundtrack)
animal_heart	animal_heart
rock_for_light	rock_for_light
ricky_martin_(1991_album)	17_(ricky_martin_album)
immortal_legacy	immortal_legacy
school_of_roses	school_of_roses
united_states_live	united_states_live
crimson_cord	crimson_cord
don't_rock_the_jukebox	don't_rock_the_jukebox
constrictor_(album)	constrictor_(album)
melana_chasmata	melana_chasmata
sparks_of_ancient_light	sparks_of_ancient_light
christmas_in_vienna_(album)	christmas_in_vienna_(album)
dream.zone.achieve	dream.zone.achieve
town_hall_concert	town_hall_concert
natasa_theodoridou_(album)	natasa_theodoridou_(album)
standards_live	standards_live
sheffield_steel	sheffield_steel
tategami_(go!go!7188_album)	tategami_(go!go!7188_album)
healing_rain	healing_rain
cahoots_(album)	cahoots_(album)
it'll_end_in_tears	it'll_end_in_tears
time_machine_(video)	time_machine_(video)
greatest_hits_volume_ii_(john_anderson_album)	greatest_hits_volume_ii_(john_anderson_album)
the_chess_box	the_chess_box
we_want_moore!	we_want_moore!
motivational_jumpsuit	motivational_jumpsuit
confessions_of_a_pop_group	confessions_of_a_pop_group
livetime	livetime
16_wit_dre,_vol._2	16_wit_dre,_vol._2
four_&_more	four_&_more
a_flower_is_a_lovesome_thing	a_flower_is_a_lovesome_thing
shyne_coldchain_vol._2	shyne_coldchain_vol._2
the_art_of_romance	the_art_of_romance
the_frankensteins_monsters_blinds	the_frankensteins_monsters_blinds
joy_spring	joy_spring
once_more!_charlie_byrd's_bossa_nova	once_more!_charlie_byrd's_bossa_nova
vintage_violence	vintage_violence
till_death_do_us_party	till_death_do_us_party
the_pleasure_principle_(gary_numan_album)	the_pleasure_principle_(gary_numan_album)
arise_therefore	arise_therefore
live_at_leeds	live_at_leeds
the_colour_of_my_love	the_colour_of_my_love
live_at_great_woods	live_at_great_woods
the_ultimate_experience	the_ultimate_experience
wakedafucup	wakedafucup
the_best_of_earth,_wind_&_fire,_vol._2	the_best_of_earth,_wind_&_fire,_vol._2
something_wicked_this_way_comes_(iced_earth_album)	something_wicked_this_way_comes_(iced_earth_album)
fuqerrbdy	fuqerrbdy
freud_euch	freud_euch
tsugi_no_ashiato	tsugi_no_ashiato
presenting_cannonball_adderley	presenting_cannonball_adderley
bulwark_bazooka	bulwark_bazooka
kissing_the_future_of_love	kissing_the_future_of_love
new_trombone	new_trombone
jolly_what!	jolly_what!
colorado_'88	colorado_'88
enter_the_slasher_house	enter_the_slasher_house
a_night_at_birdland_vol._1	a_night_at_birdland_vol._1
a_night_at_birdland_vol._2	a_night_at_birdland_vol._2
rattus_norvegicus_(album)	rattus_norvegicus_(album)
a_night_at_birdland_vol._3	a_night_at_birdland_vol._3
chronicles_(steve_winwood_album)	roll_with_it_(album)
on_your_way_home	on_your_way_home
full_frequency	full_frequency
telekon	telekon
sunny_afternoon_(compilation)	sunny_afternoon_(compilation)
children_(david_murray_album)	children_(david_murray_album)
dark_light_(gary_numan_album)	dark_light_(gary_numan_album)
the_divine_miss_m	the_divine_miss_m
i_have_dreamed_(doris_day_album)	i_have_dreamed_(doris_day_album)
african_high_life	african_high_life
blind_dog_at_st._dunstans	blind_dog_at_st._dunstans
live_(mott_the_hoople_album)	live_(mott_the_hoople_album)
live_(mott_the_hoople_album)	the_hoople
live_in_stockholm_1963	live_in_stockholm_1963
music_of_chrono_trigger	music_of_chrono_trigger
sewn_together	sewn_together
yesshows	yesshows
the_kitchen_tapes_(weezer_album)	the_kitchen_tapes_(weezer_album)
galyuu	galyuu
at_the_night_side	at_the_night_side
smilin'_buddha_cabaret	smilin'_buddha_cabaret
bare_bones_(madeleine_peyroux_album)	bare_bones_(madeleine_peyroux_album)
rockin'_the_oldies	rockin'_the_oldies
air_raid_(album)	air_raid_(album)
some_fine_old_chestnuts	some_fine_old_chestnuts
earthbound_(king_crimson_album)	earthbound_(king_crimson_album)
the_serpent's_egg	the_serpent's_egg
it's_america	it's_america
greatest_hits_(steven_curtis_chapman_album)	greatest_hits_(steven_curtis_chapman_album)
intense	intense
canterbury_fayre_2001	canterbury_fayre_2001
ne_me_quitte_pas_(album)	ne_me_quitte_pas_(album)
the_friday_rock_show_sessions	the_friday_rock_show_sessions
feel_the_fire_(overkill_album)	feel_the_fire_(overkill_album)
bbc_sessions_(cocteau_twins_album)	bbc_sessions_(cocteau_twins_album)
reba_(album)	reba_(album)
what_we_stand_for	what_we_stand_for
go_live_from_paris	go_live_from_paris
hardcore_jollies	hardcore_jollies
virgin_field	virgin_field
en_concert_(jack_johnson_album)	en_concert_(jack_johnson_album)
real_live	real_live
a_wild-eyed_christmas_night	a_wild-eyed_christmas_night
nothing_is_real	nothing_is_real
tools_of_the_trade	tools_of_the_trade
dad_loves_his_work	dad_loves_his_work
super_star_(s.h.e_album)	super_star_(s.h.e_album)
christmas_island_(album)	christmas_island_(album)
do_you_wanna_start_a_war	do_you_wanna_start_a_war
the_predator_becomes_the_prey	the_predator_becomes_the_prey
zeebratta	zeebratta
distant_light_(the_hollies_album)	distant_light_(the_hollies_album)
sgt._pepper's_lonely_hearts_club_band	sgt._pepper's_lonely_hearts_club_band
the_solo_sessions,_vol._1	the_solo_sessions,_vol._1
cause_i_sez_so	cause_i_sez_so
watch_the_sky	watch_the_sky
music_of_final_fantasy_v	music_of_final_fantasy_v
rise_of_the_machine	rise_of_the_machine
music_of_final_fantasy_x	music_of_final_fantasy_x
a_love_like_ours	a_love_like_ours
fingerprints_(album)	fingerprints_(album)
vertebrae_(album)	vertebrae_(album)
power_of_ten_(album)	power_of_ten_(album)
hang_time_(album)	hang_time_(album)
malevolent_grain	malevolent_grain
this_is_war	this_is_war
long_stretch_of_lonesome	long_stretch_of_lonesome
collectors'_items	collectors'_items
dear_dear	dear_dear
roller_coaster_track_repair	roller_coaster_track_repair
razors_on_backstreet	razors_on_backstreet
la_historia_(ricky_martin_album)	la_historia_(ricky_martin_album)
them_again	them_again
super_flight	super_flight
blue_skies_again	blue_skies_again
post_tropical	post_tropical
days_like_this_(van_morrison_album)	days_like_this_(van_morrison_album)
songs_from_tsongas	songs_from_tsongas
live!_live!_live!	live!_live!_live!
initiation_(todd_rundgren_album)	initiation_(todd_rundgren_album)
the_prophetic_herbie_nichols_vol._1	the_prophetic_herbie_nichols_vol._1
march_of_the_saint	march_of_the_saint
the_prophetic_herbie_nichols_vol._2	the_prophetic_herbie_nichols_vol._2
eho_mia_angalia	eho_mia_angalia
the_unnatural_world	the_unnatural_world
halle_(album)	halle_(album)
na_'hes_kardia	na_'hes_kardia
bette_midler_sings_the_rosemary_clooney_songbook	bette_midler_sings_the_rosemary_clooney_songbook
spend_my_time	spend_my_time
miles_ahead	miles_ahead
the_great_awakening	the_great_awakening
fatah_guerrilla	fatah_guerrilla
close_to_the_edge_(yes_album)	close_to_the_edge_(yes_album)
because_it's_christmas	because_it's_christmas
drunk_enough_to_dance	drunk_enough_to_dance
tonight_at_noon_(album)	the_clown_(album)
revolver_(beatles_album)	revolver_(beatles_album)
pain_agency	pain_agency
bette_(album)	bette_(album)
blackacetate	blackacetate
before_i_self_destruct	before_i_self_destruct
feelin'_good_train	feelin'_good_train
liquor_in_the_front	liquor_in_the_front
the_opener	the_opener
no_fools,_no_fun	no_fools,_no_fun
red_garland's_piano	red_garland's_piano
the_story_of_the_clash,_volume_1	the_story_of_the_clash,_volume_1
take_me_higher	take_me_higher
connecticut_casual	connecticut_casual
les_bourgeois	les_bourgeois
stay_with_the_hollies	stay_with_the_hollies
musicology_(album)	musicology_(album)
divine_madness_(bette_midler_album)	divine_madness_(bette_midler_album)
tales_from_topographic_oceans	tales_from_topographic_oceans
the_last_waltz_(1978_album)	the_last_waltz_(1978_album)
back_to_front_(the_temptations_album)	back_to_front_(the_temptations_album)
a_slice_of_the_top	a_slice_of_the_top
the_juliet_letters	the_juliet_letters
good_news_(kathy_mattea_album)	good_news_(kathy_mattea_album)
it's_too_late_to_stop_now	it's_too_late_to_stop_now
young_man_with_a_horn_(soundtrack)	young_man_with_a_horn_(soundtrack)
aretha_now	aretha_now
interview_(album)	playing_the_fool
metanoia_(porcupine_tree_album)	metanoia_(porcupine_tree_album)
master_of_the_moon	master_of_the_moon
may_i_sing_with_me	may_i_sing_with_me
addiction_(glenn_hughes_album)	addiction_(glenn_hughes_album)
violent_light	violent_light
blind_to_the_beautiful	blind_to_the_beautiful
two_suns	two_suns
honky_tonk_christmas	honky_tonk_christmas
addicted_(devin_townsend_project_album)	addicted_(devin_townsend_project_album)
easy_pain	easy_pain
15_big_ones	15_big_ones
for_the_love	all_wrapped_up_in_christmas
blue_moon_(toby_keith_album)	blue_moon_(toby_keith_album)
answer_(album)	answer_(album)
jt_(album)	jt_(album)
1999_(prince_album)	1999_(prince_album)
blue_resolution_(ao_no_shikaku_kaiseki_do)	blue_resolution_(ao_no_shikaku_kaiseki_do)
the_greatest_trumpet_of_them_all	the_greatest_trumpet_of_them_all
nabuma_rubberband	nabuma_rubberband
live_in_detroit,_mi	live_in_detroit,_mi
double_x_(album)	double_x_(album)
spiral_scratch_(ep)	spiral_scratch_(ep)
cool_yule	cool_yule
the_sermon!	the_sermon!
through_the_fire_(album)	through_the_fire_(album)
second_genesis_(album)	second_genesis_(album)
the_principle_of_moments	the_principle_of_moments
j'adore	j'adore
atomic_heart	atomic_heart
the_live_adventure	the_live_adventure
live_at_the_copa_(the_temptations_album)	live_at_the_copa_(the_temptations_album)
perfectly_frank	perfectly_frank
open_your_eyes_(yes_album)	open_your_eyes_(yes_album)
right_by_you	right_by_you
city_lights_(lee_morgan_album)	city_lights_(lee_morgan_album)
hankou_seimeibun	hankou_seimeibun
beat_off	beat_off
the_mourning_of_a_star	the_mourning_of_a_star
warriors_(gary_numan_album)	warriors_(gary_numan_album)
a_swingin'_christmas_(featuring_the_count_basie_big_band)	a_swingin'_christmas_(featuring_the_count_basie_big_band)
the_righteous_&_the_butterfly	the_righteous_&_the_butterfly
the_very_best_of_kim_wilde_(2001_album)	the_very_best_of_kim_wilde_(2001_album)
imperial_bedroom	imperial_bedroom
the_concert_for_bangladesh_(album)	the_concert_for_bangladesh_(album)
om_namah_shivay_(album)	om_namah_shivay_(album)
resta_in_ascolto	resta_in_ascolto
kite_(stefanie_sun_album)	kite_(stefanie_sun_album)
all_you_can_do	all_you_can_do
good_gracious!	good_gracious!
mercy,_mercy,_mercy!_live_at_'the_club'	mercy,_mercy,_mercy!_live_at_'the_club'
ladies_man_(ep)	ladies_man_(ep)
bags'_groove	bags'_groove
paul_is_live	paul_is_live
live_in_germany_1976	live_in_germany_1976
cross_point_(album)	cross_point_(album)
nearly_human	nearly_human
empire_of_the_sun_(soundtrack)	empire_of_the_sun_(soundtrack)
brubeck_time	brubeck_time
the_second_annual_report	the_second_annual_report
2_nights_live!	2_nights_live!
encore_(s.h.e_album)	encore_(s.h.e_album)
best_of_april_wine	best_of_april_wine
jimmy_smith_trio_+_ld	jimmy_smith_trio_+_ld
defying_gravity_(keith_urban_album)	defying_gravity_(keith_urban_album)
dreamcatcher_(last_autumn's_dream_album)	dreamcatcher_(last_autumn's_dream_album)
act_a_fool_(album)	act_a_fool_(album)
double_vision_(bonfire_album)	double_vision_(bonfire_album)
barry_manilow_(1989_album)	barry_manilow_(1989_album)
cobb_(soundtrack)	cobb_(soundtrack)
croz	croz
fogarty's_cove	fogarty's_cove
leave_a_mark	leave_a_mark
cover_yourself	cover_yourself
35_biggest_hits	35_biggest_hits
wazoo_(album)	wazoo_(album)
schoolboys_in_disgrace	schoolboys_in_disgrace
astral_weeks_(charles_mingus_album)	astral_weeks_(charles_mingus_album)
12_string_guitar!	12_string_guitar!
feel_(glenn_hughes_album)	feel_(glenn_hughes_album)
the_kink_kronikles	the_kink_kronikles
great_activity	great_activity
swingin'_down_yonder	swingin'_down_yonder
greatest_hits_(the_hooters_album)	out_of_body_(album)
semantics_(album)	semantics_(album)
reflections_(the_5th_dimension_album)	reflections_(the_5th_dimension_album)
the_world's_greatest_gospel_singer	the_world's_greatest_gospel_singer
b.b._king_in_london	b.b._king_in_london
remixes_2004	remixes_2004
refresh_my_heart	refresh_my_heart
running_to_follow	running_to_follow
passive_control	passive_control
curtis_fuller_volume_3	curtis_fuller_volume_3
short_sharp_shocked	short_sharp_shocked
dutch_tour_1989	dutch_tour_1989
the_madness_(album)	the_madness_(album)
the_stockholm_concert,_1966	the_stockholm_concert,_1966
buenas_noches_from_a_lonely_room	buenas_noches_from_a_lonely_room
live_at_hampton_coliseum	live_at_hampton_coliseum
in_the_heart	in_the_heart
in_utero,_in_tribute,_in_entirety	in_utero,_in_tribute,_in_entirety
thanks_for_the_feedback	thanks_for_the_feedback
pariah's_child	pariah's_child
summer_of_'78	summer_of_'78
double_take_(petra_album)	double_take_(petra_album)
the_great_burrito_extortion_case	the_great_burrito_extortion_case
holy_diver	holy_diver
sky_at_night_(album)	sky_at_night_(album)
the_beauty_of_destruction	the_beauty_of_destruction
the_genie_of_the_lamp	the_genie_of_the_lamp
instincts_(album)	instincts_(album)
dark_intervals	dark_intervals
charisma_(album)	charisma_(album)
the_last_sessions	the_last_sessions
marooned_live	marooned_live
twangin...	twangin...
little_head	little_head
i've_got_you	i've_got_you
ellington_uptown	ellington_uptown
the_phantom_moves	the_phantom_moves
stalinism_(ep)	stalinism_(ep)
the_royal_sessions	the_royal_sessions
nylon_(album)	nylon_(album)
pile_of_skulls	pile_of_skulls
like_red_on_a_rose	like_red_on_a_rose
keith_sweat_(album)	keith_sweat_(album)
rapper_gone_bad	rapper_gone_bad
a_tribute_to_my_friends	a_tribute_to_my_friends
arhizo_polemo	arhizo_polemo
best_of_sawyer_brown	best_of_sawyer_brown
under_wraps_(jethro_tull_album)	under_wraps_(jethro_tull_album)
quaristice	quaristice
machine_head_(album)	machine_head_(album)
anita_sings_the_most	anita_sings_the_most
delivering_the_black	delivering_the_black
the_biggest_bang	the_biggest_bang
discipline_(king_crimson_album)	discipline_(king_crimson_album)
the_butcher_boy_(soundtrack)	the_butcher_boy_(soundtrack)
knock_out_(bonfire_album)	knock_out_(bonfire_album)
bbc_radio_1_live_in_concert_(echo_&_the_bunnymen_album)	bbc_radio_1_live_in_concert_(echo_&_the_bunnymen_album)
rhythm_of_love_(kylie_minogue_album)	rhythm_of_love_(kylie_minogue_album)
standing_stone_(album)	standing_stone_(album)
neal_morse_(album)	neal_morse_(album)
g_n'_r_lies	g_n'_r_lies
the_last_in_line	the_last_in_line
hitstory	hitstory
love_among_the_ruins_(album)	love_among_the_ruins_(album)
(a)spera	(a)spera
no_label_2	no_label_2
second_nature_(the_young_gods_album)	second_nature_(the_young_gods_album)
once_upon_a_time_(s.h.e_album)	once_upon_a_time_(s.h.e_album)
genesis_(s.h.e_album)	genesis_(s.h.e_album)
new_times_(album)	new_times_(album)
miles_davis,_volume_3	miles_davis,_volume_3
straight_from_the_heart_(patrice_rushen_album)	straight_from_the_heart_(patrice_rushen_album)
untilted	untilted
you_can_do_better	you_can_do_better
the_final_sign_of_evil	the_final_sign_of_evil
phantom_power_(the_tragically_hip_album)	phantom_power_(the_tragically_hip_album)
ecce_cor_meum	ecce_cor_meum
nemesis_divina	intermezzo_ii
two_for_the_show_(trooper_album)	two_for_the_show_(trooper_album)
gantz_graf	gantz_graf
face_to_face_(the_kinks_album)	face_to_face_(the_kinks_album)
another_step	another_step
bocelli_(album)	bocelli_(album)
crematory_(album)	crematory_(album)
first_take_(album)	first_take_(album)
lady_soul	lady_soul
greatest_hits_(the_oak_ridge_boys_album)	greatest_hits_(the_oak_ridge_boys_album)
shiny_beast_(bat_chain_puller)	shiny_beast_(bat_chain_puller)
gong_est_mort,_vive_gong	gong_est_mort,_vive_gong
have_a_little_faith_(joe_cocker_album)	have_a_little_faith_(joe_cocker_album)
claymation_courtyard	claymation_courtyard
dactylis_glomerata	dactylis_glomerata
brill_bruisers	brill_bruisers
fire_&_ice_(yngwie_malmsteen_album)	fire_&_ice_(yngwie_malmsteen_album)
tubular_bells_iii_live	tubular_bells_iii_live
il_sogno	the_delivery_man
drag_it_up	drag_it_up
the_name_of_the_rose_(album)	the_name_of_the_rose_(album)
attica!	attica!
ruining_lives	ruining_lives
savage_gold	savage_gold
day_dreams_(doris_day_album)	day_dreams_(doris_day_album)
technique_of_relief	technique_of_relief
soul_'69	soul_'69
neon_steeple	neon_steeple
tree_of_stars	tree_of_stars
phoenix_rising_(the_temptations_album)	phoenix_rising_(the_temptations_album)
solo_monk	solo_monk
orchestral_favorites	orchestral_favorites
live_like_you_were_dying	live_like_you_were_dying
97bt99	97bt99
boomtown_(toby_keith_album)	boomtown_(toby_keith_album)
set_the_night_to_music	set_the_night_to_music
i'll_see_you_in_my_dreams_(album)	i'll_see_you_in_my_dreams_(album)
this_way_up_(album)	this_way_up_(album)
brutal_youth	brutal_youth
16_biggest_hits_(alan_jackson_album)	16_biggest_hits_(alan_jackson_album)
declaration_(steven_curtis_chapman_album)	declaration_(steven_curtis_chapman_album)
x_(anna_vissi_album)	x_(anna_vissi_album)
live_magnetism	live_magnetism
don't_back_down_(album)	don't_back_down_(album)
a_christmas_album_(amy_grant_album)	a_christmas_album_(amy_grant_album)
the_amazing_kamikaze_syndrome	the_amazing_kamikaze_syndrome
ricky_martin..._live_black_&_white_tour	ricky_martin..._live_black_&_white_tour
25_shunen_kinen_koen_tokyo_geijutsu_gekijo_5_days_~dokusou~	25_shunen_kinen_koen_tokyo_geijutsu_gekijo_5_days_~dokusou~
now_&_forever_(kim_wilde_album)	now_&_forever_(kim_wilde_album)
american_hardcore	american_hardcore
coldplay_live_2003	coldplay_live_2003
shinkai	shinkai
the_chicago_sound	the_chicago_sound
the_tokyo_tapes	the_tokyo_tapes
wanted!_the_outlaws	wanted!_the_outlaws
plain_spoken	plain_spoken
live_in_geneva_(merzbow_album)	live_in_geneva_(merzbow_album)
white_christmas_(martina_mcbride_album)	white_christmas_(martina_mcbride_album)
hymn_to_the_immortal_wind	hymn_to_the_immortal_wind
acoustica_(scorpions_album)	acoustica_(scorpions_album)
megiddo_(ep)	megiddo_(ep)
the_best_of_jean_shepard	blue_haze
from_elvis_presley_boulevard,_memphis,_tennessee	from_elvis_presley_boulevard,_memphis,_tennessee
passage_(samael_album)	passage_(samael_album)
rise_of_the_hero	rise_of_the_hero
emotion_(martina_mcbride_album)	emotion_(martina_mcbride_album)
caramba!	caramba!
higher_(harem_scarem_album)	higher_(harem_scarem_album)
swept_away_(diana_ross_album)	swept_away_(diana_ross_album)
greatest_hits_(george_strait_album)	greatest_hits_(george_strait_album)
a_perfect_contradiction	a_perfect_contradiction
a_town_called_paradise	a_town_called_paradise
siberia_(echo_&_the_bunnymen_album)	siberia_(echo_&_the_bunnymen_album)
chic-ism	chic-ism
little_johnny_c	little_johnny_c
return_of_the_reaper_(album)	return_of_the_reaper_(album)
masquerade_in_blood	masquerade_in_blood
pandora's_toys	pandora's_toys
sonic_dynamite	sonic_dynamite
heyday_(fairport_convention_album)	heyday_(fairport_convention_album)
the_fiction_maze	the_fiction_maze
it's_frightening	it's_frightening
too_far_to_care	too_far_to_care
ease_down_the_road	ease_down_the_road
free_(marcus_miller_album)	free_(marcus_miller_album)
keith_sweat_live	keith_sweat_live
recording_n.y.c._1986	recording_n.y.c._1986
my_kind_of_country_(reba_mcentire_album)	my_kind_of_country_(reba_mcentire_album)
hard_workin'_man	hard_workin'_man
181920	181920
stacked_rubbish	stacked_rubbish
man_in_the_moon_(l.a._guns_album)	man_in_the_moon_(l.a._guns_album)
first_(denise_ho_album)	first_(denise_ho_album)
14_friendly_abductions	14_friendly_abductions
chun-king	chun-king
under_the_desert_sky	under_the_desert_sky
desert_winds	desert_winds
peppermint_pig	peppermint_pig
the_price_of_progression_(the_toll_album)	the_price_of_progression_(the_toll_album)
steppin'_out!	steppin'_out!
wide_open_(jason_aldean_album)	wide_open_(jason_aldean_album)
king_crimson_live_in_hyde_park,_london	king_crimson_live_in_hyde_park,_london
there_is_no-one_what_will_take_care_of_you	there_is_no-one_what_will_take_care_of_you
master_of_disaster	master_of_disaster
double_play!	double_play!
the_shit_hits_the_fans	the_shit_hits_the_fans
hello_broadway	hello_broadway
fair_&_square	fair_&_square
my_krazy_life	my_krazy_life
does_fort_worth_ever_cross_your_mind	does_fort_worth_ever_cross_your_mind
kiss_40	kiss_40
ganryu_island_(album)	ganryu_island_(album)
back_to_broadway	back_to_broadway
hello_young_lovers_(sparks_album)	hello_young_lovers_(sparks_album)
see_the_light_(the_jeff_healey_band_album)	see_the_light_(the_jeff_healey_band_album)
the_good,_the_bad_&_the_live	metallica_(album)
una_mas	una_mas
the_song_book	the_song_book
cornbread_(album)	cornbread_(album)
shapes_of_screams	shapes_of_screams
dave's_picks_volume_10	dave's_picks_volume_10
breed_to_breathe	breed_to_breathe
anicca_(album)	anicca_(album)
live_at_the_it_club	live_at_the_it_club
circus_hero	circus_hero
twelve_songs_of_christmas	twelve_songs_of_christmas
quaristice.quadrange.ep.ae	quaristice.quadrange.ep.ae
life_(ricky_martin_album)	life_(ricky_martin_album)
so-lo	best_o'_boingo
higher_ground_(barbra_streisand_album)	higher_ground_(barbra_streisand_album)
pink_moon	pink_moon
the_cooker	the_cooker
the_runaways_(album)	the_runaways_(album)
casual_viewin'	casual_viewin'
the_construkction_of_light	the_construkction_of_light
ravenous_(wolf_album)	ravenous_(wolf_album)
the_temptations_show	the_temptations_show
the_wheel	the_wheel
the_eminent_jay_jay_johnson_volume_2	the_eminent_jay_jay_johnson_volume_2
louis_armstrong_meets_oscar_peterson	louis_armstrong_meets_oscar_peterson
fantasies_(album)	fantasies_(album)
buckminster_fuller_(ep)	buckminster_fuller_(ep)
carelessly_yours	carelessly_yours
noise_for_music's_sake	noise_for_music's_sake
music_of_the_final_fantasy_tactics_series	music_of_the_final_fantasy_tactics_series
live_at_the_apollo_(hall_&_oates_album)	live_at_the_apollo_(hall_&_oates_album)
10_song_demo	10_song_demo
casual_viewin'_usa	casual_viewin'_usa
kartagina	kartagina
ross_(1983_album)	ross_(1983_album)
american_interior	american_interior
the_beatles_at_the_hollywood_bowl	the_beatles_at_the_hollywood_bowl
the_people_in_your_neighbourhood	the_people_in_your_neighbourhood
wearing_a_martyr's_crown	wearing_a_martyr's_crown
music_for_the_divine	music_for_the_divine
a_fistful_of_alice	a_fistful_of_alice
let_the_world_know	let_the_world_know
stripped_(tour)	stripped_(tour)
for_the_boys_(soundtrack)	for_the_boys_(soundtrack)
script_of_the_bridge	script_of_the_bridge
the_eminem_show	encore_(eminem_album)
nick_&_knight	nick_&_knight
the_voice_(bobby_mcferrin_album)	the_voice_(bobby_mcferrin_album)
lost_in_the_dream	lost_in_the_dream
special_herbs,_vols._5_&_6	special_herbs,_vols._5_&_6
nana_best	nana_best
stitt_goes_latin	stitt_goes_latin
hollywood_vampires	hollywood_vampires
i_marinella_tragouda_ke_thimate	i_marinella_tragouda_ke_thimate
(sic)nesses	(sic)nesses
up_against_my_heart	up_against_my_heart
inventor_of_evil	inventor_of_evil
candy_for_the_clowns	candy_for_the_clowns
heaven_or_las_vegas	heaven_or_las_vegas
fuel_to_the_flames	fuel_to_the_flames
the_millennium_bell	the_millennium_bell
let_me_be_the_one_(album)	let_me_be_the_one_(album)
it's_not_what_you_say..._it's_how_you_say_it	it's_not_what_you_say..._it's_how_you_say_it
all_i_really_want_for_christmas	all_i_really_want_for_christmas
out_of_my_hands_(jennifer_rush_album)	out_of_my_hands_(jennifer_rush_album)
magnification_(album)	magnification_(album)
strait_country	strait_country
nonaah	nonaah
sheezus	sheezus
from_the_cradle_to_the_grave_(album)	from_the_cradle_to_the_grave_(album)
travma	travma
morning_phase	morning_phase
remix_to_sing	remix_to_sing
zipper_catches_skin	zipper_catches_skin
through_the_past,_darkly_(big_hits_vol._2)	through_the_past,_darkly_(big_hits_vol._2)
a_wonderful_world	a_wonderful_world
muscle_of_love	muscle_of_love
the_power_to_believe	the_power_to_believe
whigfield_sextape	whigfield_sextape
straight_no_filter	straight_no_filter
camouflage_(rod_stewart_album)	camouflage_(rod_stewart_album)
live_seventy_nine	live_seventy_nine
greatest_hits_ii_(clint_black_album)	greatest_hits_ii_(clint_black_album)
superwolf	superwolf
precious_memories_(alan_jackson_album)	precious_memories_(alan_jackson_album)
greatest_hits_(tracy_byrd_album)	greatest_hits_(tracy_byrd_album)
career_moves	career_moves
keep_it_simple	keep_it_simple
indigo_algorithm_(ai_no_denshi_kisuuhou)	indigo_algorithm_(ai_no_denshi_kisuuhou)
lee_morgan_vol._3	lee_morgan_vol._3
extracts_from_the_film_a_hard_day's_night	extracts_from_the_film_a_hard_day's_night
definitely_maybe	be_here_now_(album)
definitely_maybe	stop_the_clocks
blue_spoon	blue_spoon
we_want_more	we_want_more
common_one	common_one
pale_communion	pale_communion
rock_the_world_(five_star_album)	rock_the_world_(five_star_album)
dance_tracks_vol.1	dance_tracks_vol.1
liars_(todd_rundgren_album)	liars_(todd_rundgren_album)
license_to_chill	license_to_chill
be_(casiopea_album)	be_(casiopea_album)
ellington_indigos	ellington_indigos
live_at_the_budokan_(chic_album)	live_at_the_budokan_(chic_album)
liege_&_lief	liege_&_lief
klagopsalmer	klagopsalmer
dedication_(zomby_album)	dedication_(zomby_album)
become_the_media	become_the_media
live_life_living	live_life_living
volk_(album)	volk_(album)
soulville	soulville
gold_(joe_cocker_album)	gold_(joe_cocker_album)
kati_simveni	kati_simveni
strong_feelings	strong_feelings
batman_forever_(score)	batman_forever_(score)
kurutta_taiyou	kurutta_taiyou
painful_(album)	painful_(album)
you_had_to_be_there	you_had_to_be_there
kravgi	kravgi
green_(r.e.m._album)	green_(r.e.m._album)
the_best_of_hocc	the_best_of_hocc
for_girls_who_grow_plump_in_the_night	for_girls_who_grow_plump_in_the_night
i_just_came_home_to_count_the_memories	i_just_came_home_to_count_the_memories
bromst	bromst
killin'_time_(clint_black_album)	killin'_time_(clint_black_album)
d.e._7th	d.e._7th
rock_messiah	rock_messiah
teases_&_dares	teases_&_dares
john_michael_montgomery_(album)	john_michael_montgomery_(album)
the_rolling_stones,_now!	the_rolling_stones,_now!
undisclosed_files_addendum	undisclosed_files_addendum
sonny_clark_trio	sonny_clark_trio
the_greatest_hits_collection_ii	the_greatest_hits_collection_ii
when_fallen_angels_fly	when_fallen_angels_fly
the_beatles'_hits	the_beatles'_hits
horror_show_(album)	horror_show_(album)
instinct_(iggy_pop_album)	instinct_(iggy_pop_album)
ultimate_manilow	ultimate_manilow
one_nite_alone..._live!	one_nite_alone..._live!
lee_morgan_indeed!	lee_morgan_indeed!
closing_in_on_the_fire	closing_in_on_the_fire
revival_(petra_album)	revival_(petra_album)
possum_head	possum_head
the_gold_medal_collection	the_gold_medal_collection
extracts_from_the_album_a_hard_day's_night	extracts_from_the_album_a_hard_day's_night
songs_in_the_key_of_rock	songs_in_the_key_of_rock
body_language_(kylie_minogue_album)	body_language_(kylie_minogue_album)
heart_&_soul_(joe_cocker_album)	heart_&_soul_(joe_cocker_album)
angels_of_the_apocalypse	angels_of_the_apocalypse
animetal_marathon_iv	animetal_marathon_iv
burning_the_days	burning_the_days
emotion_(barbra_streisand_album)	emotion_(barbra_streisand_album)
peggy_zina_(album)	peggy_zina_(album)
s.w.a.t._(soundtrack)	s.w.a.t._(soundtrack)
master_of_puppets	master_of_puppets
fun-fare	fun-fare
crocodiles_(album)	crocodiles_(album)
the_modern_jazz_quartet_plays_no_sun_in_venice	the_modern_jazz_quartet_plays_no_sun_in_venice
dragontown	dragontown
the_rajah_(album)	the_rajah_(album)
the_antichrist_(album)	the_antichrist_(album)
dans_ma_chair	dans_ma_chair
the_best_of_the_specials	the_best_of_the_specials
the_last_of_the_gypsies	the_last_of_the_gypsies
angst_in_my_pants	angst_in_my_pants
the_best_of_10cc_live	the_best_of_10cc_live
show_time_(doris_day_album)	show_time_(doris_day_album)
laura_(laura_pausini_album)	laura_(laura_pausini_album)
days_of_purgatory	days_of_purgatory
in_the_lonely_hour	in_the_lonely_hour
more_to_this_life	more_to_this_life
mode_for_joe	mode_for_joe
talkin'_about!	talkin'_about!
april_wine_rocks!	april_wine_rocks!
bass_on_top	bass_on_top
everything_is_everything_(diana_ross_album)	everything_is_everything_(diana_ross_album)
we_three_kings_(the_reverend_horton_heat_album)	we_three_kings_(the_reverend_horton_heat_album)
are_you_experienced	the_ultimate_experience
black_hawk_down_(soundtrack)	black_hawk_down_(soundtrack)
hot_dreams	hot_dreams
attack_of_the_mutant_50ft_kebab	attack_of_the_mutant_50ft_kebab
gifts_&_messages	gifts_&_messages
ubieranie_do_snu	ubieranie_do_snu
flaming_pie	flaming_pie
la_toya_jackson_(album)	la_toya_jackson_(album)
better_days_comin'	better_days_comin'
in_god_we_trust_(stryper_album)	in_god_we_trust_(stryper_album)
rooms_of_the_house	rooms_of_the_house
the_best_of_the_early_years_(b.b._king_album)	the_best_of_the_early_years_(b.b._king_album)
to_be_kind	to_be_kind
tonight_(david_bowie_album)	tonight_(david_bowie_album)
unplugged_(the_official_bootleg)	unplugged_(the_official_bootleg)
blank_project	blank_project
gun_aramaic	gun_aramaic
schizophrenia_(wayne_shorter_album)	schizophrenia_(wayne_shorter_album)
christmas_with_weezer	christmas_with_weezer
time_passes_by	time_passes_by
love's_easy_tears	love's_easy_tears
the_clown_(album)	the_clown_(album)
keep_it_hid	keep_it_hid
1000_forms_of_fear	1000_forms_of_fear
this_old_road	this_old_road
the_lost_lolli	the_lost_lolli
the_beatles_(no._1)	the_beatles_(no._1)
apagorevmeno	apagorevmeno
boi-ngo	boingo_alive
azn_pride_-this_iz_the_japanese_kabuki_rock-	azn_pride_-this_iz_the_japanese_kabuki_rock-
broken_crown_halo	broken_crown_halo
the_works_(echo_&_the_bunnymen_album)	the_works_(echo_&_the_bunnymen_album)
a_new_hallelujah	a_new_hallelujah
i_epomeni_kinisi	i_epomeni_kinisi
wailing_with_lou	wailing_with_lou
amber_(autechre_album)	amber_(autechre_album)
live_at_sturgis	live_at_sturgis
cocked_&_loaded	cocked_&_loaded
got_live_if_you_want_it!_(album)	got_live_if_you_want_it!_(album)
a_little_touch_of_schmilsson_in_the_night	a_little_touch_of_schmilsson_in_the_night
we_rock_(dvd)	a_special_from_the_spectrum
we_rock_(dvd)	we_rock_(dvd)
broke_with_expensive_taste	broke_with_expensive_taste
hobo_(charlie_winston_album)	hobo_(charlie_winston_album)
the_mamas_&_the_papas_(album)	the_mamas_&_the_papas_(album)
overdressed	overdressed
peace_kehd	peace_kehd
orange_compile_(daidai_no_noudou_hensekishiki)	orange_compile_(daidai_no_noudou_hensekishiki)
black_hand_inn	black_hand_inn
hail_the_apocalypse	hail_the_apocalypse
girl's_dorm	girl's_dorm
bread_&_circus	bread_&_circus
new_crown	new_crown
touch_(sarah_mclachlan_album)	touch_(sarah_mclachlan_album)
shaday	shaday
as_sure_as_the_sun	as_sure_as_the_sun
colosseum_live	colosseum_live
parade_(go!go!7188_album)	parade_(go!go!7188_album)
love_me_for_a_reason_-_the_collection	love_me_for_a_reason_-_the_collection
white_people_party_music	white_people_party_music
greatest_hits_(joe_diffie_album)	greatest_hits_(joe_diffie_album)
strange_angels_(laurie_anderson_album)	strange_angels_(laurie_anderson_album)
a_hangover_you_don't_deserve	a_hangover_you_don't_deserve
dconstructed	dconstructed
north_(elvis_costello_album)	north_(elvis_costello_album)
1_+_1_(album)	1_+_1_(album)
chuck_berry_twist	chuck_berry_twist
myv_pops	myv_pops
his_definitive_greatest_hits	his_definitive_greatest_hits
metal_magic	metal_magic
cole_slaw	cole_slaw
songs_from_the_south	songs_from_the_south
art_farmer_quintet_featuring_gigi_gryce	art_farmer_quintet_featuring_gigi_gryce
special_herbs,_vols._7_&_8	special_herbs,_vols._7_&_8
english_oceans	english_oceans
imaginary_day	imaginary_day
head_trip_in_every_key	head_trip_in_every_key
beat_(album)	beat_(album)
the_essential_luther_vandross	the_essential_luther_vandross
catch_as_catch_can_(album)	catch_as_catch_can_(album)
heaven_in_the_real_world	heaven_in_the_real_world
merry_christmas_strait_to_you!	merry_christmas_strait_to_you!
against_the_light	against_the_light
fungus_amongus	when_incubus_attacks_volume_1
absu_(album)	absu_(album)
coming_home_(faye_wong_album)	coming_home_(faye_wong_album)
one_kind_favor	one_kind_favor
odludek	odludek
in_trance	in_trance
fallen_leaves_&_dead_sparrows	fallen_leaves_&_dead_sparrows
it's_pimpin'_pimpin'	it's_pimpin'_pimpin'
gorilla_(james_taylor_album)	gorilla_(james_taylor_album)
inside_out_(dilana_album)	inside_out_(dilana_album)
the_ways_of_yore	the_ways_of_yore
a_medio_vivir_(album)	the_best_of_ricky_martin
the_body_&_the_soul	the_body_&_the_soul
vicious_circle_(l.a._guns_album)	vicious_circle_(l.a._guns_album)
flowers_(the_rolling_stones_album)	between_the_buttons
12_x_5	12_x_5
bt_(album)	bt_(album)
le_cose_che_vivi	le_cose_che_vivi
the_best_of_the_specials_&_fun_boy_three	the_best_of_the_specials_&_fun_boy_three
doug_stone_(album)	doug_stone_(album)
let_it_be_christmas	let_it_be_christmas
this_is_christmas_(luther_vandross_album)	this_is_christmas_(luther_vandross_album)
the_brotherhood_(album)	the_brotherhood_(album)
winger_(album)	winger_(album)
more_of_roy_orbison's_greatest_hits	more_of_roy_orbison's_greatest_hits
beyond_the_blue_neon	beyond_the_blue_neon
cold_lake_(album)	cold_lake_(album)
live_(candlemass_album)	live_(candlemass_album)
bowling_for_soup_goes_to_the_movies	bowling_for_soup_goes_to_the_movies
tubular_bells_ii	tubular_bells_ii
weather_report_(1971_album)	weather_report_(1971_album)
boss_shoutin'	boss_shoutin'
plays_pretty_just_for_you	plays_pretty_just_for_you
alice_&_june	alice_&_june
o!_kypros	o!_kypros
dreamin'_my_dreams_(patty_loveless_album)	dreamin'_my_dreams_(patty_loveless_album)
the_ten_commandments_(malevolent_creation_album)	the_ten_commandments_(malevolent_creation_album)
foggy_highway	foggy_highway
quand_on_n'a_que_l'amour	quand_on_n'a_que_l'amour
jazz_...it's_magic!	jazz_...it's_magic!
masterpieces_by_ellington	masterpieces_by_ellington
end_of_the_world_party_(just_in_case)	end_of_the_world_party_(just_in_case)
somali_songs_from_the_diaspora	somali_songs_from_the_diaspora
you_can't_triple_stamp_a_double_stamp	you_can't_triple_stamp_a_double_stamp
working_classical	working_classical
live!_vampires	live!_vampires
s-mode_1	s-mode_1
on_the_cover_ii	on_the_cover_ii
torn_from_black_space	torn_from_black_space
paris_1919_(album)	paris_1919_(album)
a_night_to_remember_(joe_diffie_album)	a_night_to_remember_(joe_diffie_album)
kainourgia_ego	kainourgia_ego
a_night_at_the_village_vanguard	a_night_at_the_village_vanguard
night_calls_(album)	night_calls_(album)
sentimento	sentimento
saving_private_ryan_(soundtrack)	saving_private_ryan_(soundtrack)
three_friends	octopus_(gentle_giant_album)
boucan_d'enfer	boucan_d'enfer
confield	confield
tears_for_dolphy	tears_for_dolphy
anthology_(oingo_boingo_album)	anthology_(oingo_boingo_album)
the_coast_is_clear_(tracy_lawrence_album)	the_coast_is_clear_(tracy_lawrence_album)
willow_in_the_wind	willow_in_the_wind
back_in_the_world_live	back_in_the_world_live
s-mode_2	s-mode_2
s-mode_3	s-mode_3
days_of_the_fallen_sun	days_of_the_fallen_sun
education,_education,_education_&_war	education,_education,_education_&_war
childhood_home	childhood_home
man_on_the_line	man_on_the_line
king_crimson_live_at_summit_studios	king_crimson_live_at_summit_studios
night_moves_(album)	night_moves_(album)
greatest_hits!	greatest_hits!
snap!_(album)	snap!_(album)
bondage_(album)	bondage_(album)
live_pcppep	live_pcppep
longnecks_&_short_stories	almost_goodbye
at_war_with_satan	at_war_with_satan
out_of_our_heads	out_of_our_heads
king_crimson_live_at_plymouth_guildhall	king_crimson_live_at_plymouth_guildhall
ep_1_joey	ep_1_joey
life's_so_funny	life's_so_funny
arc_of_a_diver	arc_of_a_diver
chromaticity_(album)	chromaticity_(album)
love_grenade	love_grenade
waymore's_blues_(part_ii)	waymore's_blues_(part_ii)
sunbathing_animal	sunbathing_animal
golden_streets_of_glory	golden_streets_of_glory
jamming_with_edward!	jamming_with_edward!
how_we_both_wondrously_perish	how_we_both_wondrously_perish
the_silent_enigma	the_silent_enigma
a_long_drink_of_the_blues	a_long_drink_of_the_blues
the_bridge_(concept_of_a_culture)	the_bridge_(concept_of_a_culture)
the_classic_guide_to_strategy	the_classic_guide_to_strategy
me_&_paul	me_&_paul
shadowdance_(shadowfax_album)	shadowdance_(shadowfax_album)
miles_in_berlin	miles_in_berlin
california_years	california_years
cracked_brain	cracked_brain
petra_farewell	petra_farewell
the_road_hammers_ii	the_road_hammers_ii
jagged_edge_(gary_numan_album)	jagged_edge_(gary_numan_album)
surrealistic_pillow	surrealistic_pillow
shut_down_volume_2	shut_down_volume_2
love_&_hate_(lil_rob_album)	love_&_hate_(lil_rob_album)
graveyard_classics	graveyard_classics
at_the_end_of_a_perfect_day	at_the_end_of_a_perfect_day
transgender_dysphoria_blues	transgender_dysphoria_blues
yellow_submarine_(album)	yellow_submarine_(album)
kickin'_it_up	kickin'_it_up
best_of_the_beach_boys	best_of_the_beach_boys
quiet_revolution_(album)	quiet_revolution_(album)
music_for_artificial_clouds	music_for_artificial_clouds
incomplete_me	incomplete_me
john_anderson_(album)	john_anderson_(album)
sinatra,_with_love	sinatra,_with_love
volume_3_(the_easybeats_album)	volume_3_(the_easybeats_album)
escape_(whodini_album)	escape_(whodini_album)
love_on_the_beat	love_on_the_beat
i_never_loved_a_man_the_way_i_love_you	i_never_loved_a_man_the_way_i_love_you
chiastic_slide	chiastic_slide
blow_my_fuse	blow_my_fuse
the_power_of_two	the_power_of_two
be_here_now_(album)	be_here_now_(album)
magnetic_fields_(album)	magnetic_fields_(album)
zebra_(zebra_album)	zebra_(zebra_album)
king_biscuit_flower_hour_(zebra_album)	king_biscuit_flower_hour_(zebra_album)
choba_b_cccp	choba_b_cccp
tubular_bells_ii_live	tubular_bells_ii_live
code_red_(sodom_album)	code_red_(sodom_album)
green_method_(midori_no_chuuyou_chitsujyo_kei)	green_method_(midori_no_chuuyou_chitsujyo_kei)
estoile_naiant	estoile_naiant
mis_40_en_bellas_artes	mis_40_en_bellas_artes
john_mayall_plays_john_mayall	john_mayall_plays_john_mayall
in_the_hollows	in_the_hollows
miss_show_business	miss_show_business
we_lost_the_skyline	we_lost_the_skyline
strong_(tracy_lawrence_album)	strong_(tracy_lawrence_album)
i_kinda_like_me	i_kinda_like_me
trilogy_(yngwie_malmsteen_album)	trilogy_(yngwie_malmsteen_album)
have_a_good_time_(album)	have_a_good_time_(album)
collapse_12_floors	collapse_12_floors
blue_moods	blue_moods
n.e.w.s_(prince_album)	n.e.w.s_(prince_album)
li-book_2000	li-book_2000
live_at_the_apollo_(robert_palmer_album)	heavy_nova_(album)
may_death_never_stop_you	may_death_never_stop_you
summer_sun	summer_sun
kinda_kinks	kinda_kinks
labyrinthes	labyrinthes
the_da_vinci_code_(soundtrack)	the_da_vinci_code_(soundtrack)
esoteric_warfare	esoteric_warfare
4_(johan_album)	4_(johan_album)
roger_the_engineer	roger_the_engineer
send_away_the_tigers	send_away_the_tigers
wings_of_desire_(album)	wings_of_desire_(album)
big_band_explosion	big_band_explosion
now,_diabolical	now,_diabolical
stereolithic	stereolithic
saurian_exorcisms	saurian_exorcisms
forget_the_world_(afrojack_album)	forget_the_world_(afrojack_album)
i_have_a_right	i_have_a_right
the_ever_popular_tortured_artist_effect	the_ever_popular_tortured_artist_effect
pepsi_beats_of_the_beautiful_game	pepsi_beats_of_the_beautiful_game
perfect_3_world_tour_live_@_hong_kong	perfect_3_world_tour_live_@_hong_kong
blue_bell_knoll	blue_bell_knoll
condition_critical	condition_critical
5._april_'81	5._april_'81
waiting_for_cousteau	waiting_for_cousteau
elvis'_christmas_album	elvis'_christmas_album
goddess_of_love_(album)	goddess_of_love_(album)
the_dark_knight_(soundtrack)	the_dark_knight_(soundtrack)
tejas_(album)	tejas_(album)
music_speaks	music_speaks
born_again_(black_sabbath_album)	born_again_(black_sabbath_album)
runt._the_ballad_of_todd_rundgren	runt._the_ballad_of_todd_rundgren
phantasmagoria_(nobuo_uematsu_album)	phantasmagoria_(nobuo_uematsu_album)
live_at_the_westbeth_theater	live_at_the_westbeth_theater
sacred_heart_(dio_album)	sacred_heart_(dio_album)
dream_with_dean	dream_with_dean
hymn_for_my_soul	hymn_for_my_soul
death_to_analog	death_to_analog
special_herbs,_vols._9_&_0	special_herbs,_vols._9_&_0
life_in_lucidity	life_in_lucidity
too_long_in_exile	too_long_in_exile
our_endless_war	our_endless_war
all_the_world's_a_stage_(album)	all_the_world's_a_stage_(album)
this_iz_the_japanese_kabuki_rock	this_iz_the_japanese_kabuki_rock
no_parole_from_rock_'n'_roll	no_parole_from_rock_'n'_roll
classic_masters_(april_wine_album)	classic_masters_(april_wine_album)
songs_from_the_south_volume_2	songs_from_the_south_volume_2
grand_jacques	grand_jacques
back_to_the_mansion	back_to_the_mansion
hit_parade_(paul_weller_album)	hit_parade_(paul_weller_album)
fancy_free_(the_oak_ridge_boys_album)	fancy_free_(the_oak_ridge_boys_album)
you'll_never_walk_alone_(doris_day_album)	you'll_never_walk_alone_(doris_day_album)
socialized_hate	socialized_hate
standing_on_the_shoulder_of_giants	familiar_to_millions
ugra-karma	ugra-karma
ooku_(album)	ooku_(album)
bossa_nova_hotel	bossa_nova_hotel
soul_shack	soul_shack
it's_a_wonderful_christmas	it's_a_wonderful_christmas
labor_of_love_(sammy_kershaw_album)	labor_of_love_(sammy_kershaw_album)
repeat_when_necessary	repeat_when_necessary
hi-tek_(album)	hi-tek_(album)
sings_hank_williams	sings_hank_williams
mambo_sinuendo	mambo_sinuendo
strong_heart	strong_heart
from_enslavement_to_obliteration	from_enslavement_to_obliteration
naughty_baby	naughty_baby
worship_(michael_w._smith_album)	worship_(michael_w._smith_album)
the_serpent_&_the_sphere	the_serpent_&_the_sphere
a_night_to_remember_(cyndi_lauper_album)	a_night_to_remember_(cyndi_lauper_album)
fromohio	fromohio
fort_yawuh	fort_yawuh
space_wrangler	space_wrangler
perfectly_good_guitar	perfectly_good_guitar
miles_smiles	miles_smiles
starters_in_the_game	starters_in_the_game
focus_ii	focus_ii
blizzard_of_ozz	blizzard_of_ozz
the_ghost_in_science	the_ghost_in_science
remix_stories_vol._2	remix_stories_vol._2
merry_christmas_wherever_you_are	merry_christmas_wherever_you_are
incognito_(celine_dion_album)	incognito_(celine_dion_album)
xxy_(album)	xxy_(album)
four_seasons_of_love	four_seasons_of_love
the_mccartney_years	the_mccartney_years
miles_davis_volume_1	miles_davis_volume_1
silk_road_of_love	silk_road_of_love
rave_tapes	rave_tapes
miles_davis_volume_2	miles_davis_volume_2
mercyful_fate_(ep)	mercyful_fate_(ep)
hard_rain_(bob_dylan_album)	hard_rain_(bob_dylan_album)
the_fabulous_8-track_sound_of_superdrag	the_fabulous_8-track_sound_of_superdrag
never_breathe_what_you_can't_see	never_breathe_what_you_can't_see
fist_of_god	fist_of_god
make_it_last_forever_(album)	make_it_last_forever_(album)
summer_hits_no._1	summer_hits_no._1
village_life	village_life
ta_prota_hronia	ta_prota_hronia
extension_of_a_man	extension_of_a_man
higher_ground_(john_denver_album)	higher_ground_(john_denver_album)
like_gods_of_the_sun	like_gods_of_the_sun
ghost_(gary_numan_album)	ghost_(gary_numan_album)
everything_i_am	everything_i_am
daryl_hall_&_john_oates_(album)	daryl_hall_&_john_oates_(album)
oh,_common_life	oh,_common_life
the_glorious_burden	the_glorious_burden
voyager_(mike_oldfield_album)	voyager_(mike_oldfield_album)
beaches_(soundtrack)	beaches_(soundtrack)
amor_vincit_omnia_(pure_reason_revolution_album)	amor_vincit_omnia_(pure_reason_revolution_album)
i_would_like_to_see_you_again	i_would_like_to_see_you_again
love_is_(kim_wilde_album)	love_is_(kim_wilde_album)
step_up_to_the_microphone	step_up_to_the_microphone
lifeline_(neal_morse_album)	lifeline_(neal_morse_album)
by_the_light_of_the_silvery_moon_(album)	by_the_light_of_the_silvery_moon_(album)
noble_beast	noble_beast
view_from_the_house	view_from_the_house
mr_crowley_live_ep	mr_crowley_live_ep
jazz_eyes	jazz_eyes
intermodulation_(album)	intermodulation_(album)
ride_the_lightning	ride_the_lightning
symbols_(album)	symbols_(album)
laura_pausini_(1994_album)	laura_pausini_(1994_album)
little_lost_blues	the_letting_go
live_at_the_village_vanguard_again!	live_at_the_village_vanguard_again!
four_by_the_beach_boys	four_by_the_beach_boys
farewell_(oingo_boingo_album)	farewell_(oingo_boingo_album)
venomous_villain	venomous_villain
my_oracle_lives_uptown	my_oracle_lives_uptown
if_i_could_do_it_all_over_again,_i'd_do_it_all_over_you	if_i_could_do_it_all_over_again,_i'd_do_it_all_over_you
unrepentant_geraldines	unrepentant_geraldines
thelonious_monk_with_john_coltrane	thelonious_monk_with_john_coltrane
four_(blues_traveler_album)	four_(blues_traveler_album)
reach_for_the_sky_(ratt_album)	reach_for_the_sky_(ratt_album)
hurry_up_mode	hurry_up_mode
the_george_benson_cookbook	the_george_benson_cookbook
louis_armstrong_at_the_crescendo,_vol._1	louis_armstrong_at_the_crescendo,_vol._1
a_hard_road	a_hard_road
in_the_court_of_the_crimson_king	in_the_court_of_the_crimson_king
ep_2_don't_miss	ep_2_don't_miss
great_western_valkyrie	great_western_valkyrie
beyond_the_blue_mosque	beyond_the_blue_mosque
a_classic_christmas_(toby_keith_album)	a_classic_christmas_(toby_keith_album)
recoiled	recoiled
new_faces,_new_sounds	new_faces,_new_sounds
the_eyes_of_alice_cooper	the_eyes_of_alice_cooper
wings_of_love_(fish_leong_album)	wings_of_love_(fish_leong_album)
a_christmas_gift_of_love	a_christmas_gift_of_love
play_(namie_amuro_album)	play_(namie_amuro_album)
in_cold_blood_(malevolent_creation_album)	in_cold_blood_(malevolent_creation_album)
the_rockville_lp	the_rockville_lp
kim_wilde_(album)	kim_wilde_(album)
speechless_(steven_curtis_chapman_album)	speechless_(steven_curtis_chapman_album)
o_vertigo!	o_vertigo!
keep_it_comin'	keep_it_comin'
a_fine_day_to_exit	resonance_(anathema_album)
give_me_fire!	give_me_fire!
unleashed_(toby_keith_album)	unleashed_(toby_keith_album)
le_bataclan_'72	le_bataclan_'72
the_last_waltz_(2002_album)	the_last_waltz_(1978_album)
envane	envane
bright_red	bright_red
feedback_file_2	feedback_file_2
ultrablessed	ultrablessed
silver_rails	silver_rails
walk_on_(john_hiatt_album)	walk_on_(john_hiatt_album)
the_trouble_with_the_truth	the_trouble_with_the_truth
crown_&_clown	crown_&_clown
close_to_the_glass	close_to_the_glass
in_the_hands_of_god	in_the_hands_of_god
the_tiki_bar_is_open	the_tiki_bar_is_open
evaisthisies	evaisthisies
soul_mover	soul_mover
the_museum_(album)	the_museum_(album)
beware_(album)	beware_(album)
dave's_picks_volume_9	dave's_picks_volume_9
jazz_recital	jazz_recital
meet_the_beatles!	meet_the_beatles!
tracy_lawrence_(album)	tracy_lawrence_(album)
aretha_arrives	aretha_arrives
see_ya_'round	see_ya_'round
tripping_the_live_fantastic	tripping_the_live_fantastic
live!_(fela_kuti_album)	live!_(fela_kuti_album)
kill_'em_all	kill_'em_all
animal_ambition	animal_ambition
twice_upon_a_time_(joe_diffie_album)	twice_upon_a_time_(joe_diffie_album)
incanto	incanto
live_at_mccabe's_(henry_rollins_album)	live_at_mccabe's_(henry_rollins_album)
better_off_dead_(album)	better_off_dead_(album)
the_songs_of_distant_earth_(album)	the_songs_of_distant_earth_(album)
in_violet_light	in_violet_light
live_at_the_village_vanguard_(michel_petrucciani_album)	live_at_the_village_vanguard_(michel_petrucciani_album)
chapter_one..._a_decade	chapter_one..._a_decade
worse_than_alone	worse_than_alone
damaged_(lambchop_album)	damaged_(lambchop_album)
city_of_ferris_wheels	city_of_ferris_wheels
in_death_reborn	in_death_reborn
richard_d._james_album	richard_d._james_album
reload_(metallica_album)	load_(album)
wet_(album)	wet_(album)
tommy_(album)	tommy_(album)
bette_midler_(album)	bette_midler_(album)
barry_(album)	barry_(album)
blue_light_'til_dawn	blue_light_'til_dawn
smear_campaign_(album)	smear_campaign_(album)
we_are_the_mess	we_are_the_mess
trip_(rivermaya_album)	trip_(rivermaya_album)
le_mot_de_passe	le_mot_de_passe
boomtown_(ozma_album)	boomtown_(ozma_album)
only_heaven	only_heaven
the_u.s._albums	the_u.s._albums
spirit_in_the_dark	this_girl's_in_love_with_you
spirit_in_the_dark	spirit_in_the_dark
honkytonk_university	honkytonk_university
monumension	monumension
the_seventh_sign_(album)	the_seventh_sign_(album)
book_burner	book_burner
my_point_of_view	my_point_of_view
enemy_of_the_music_business	enemy_of_the_music_business
satanic_rites	satanic_rites
ghost_empire	ghost_empire
klima_tropiko	klima_tropiko
cowboy_town	cowboy_town
white_devil_armory	white_devil_armory
spacebrock	spacebrock
testimony_(neal_morse_album)	testimony_(neal_morse_album)
isla_del_sol_(album)	isla_del_sol_(album)
let's_talk_about_love	let's_talk_about_love
all_love's_legal	all_love's_legal
we_r_are_why	we_r_are_why
l'heptade	l'heptade
live_in_central_park,_nyc	live_in_central_park,_nyc
mondo_cane_(album)	mondo_cane_(album)
ode_to_echo	ode_to_echo
your_secret_love	your_secret_love
200_motels_(soundtrack)	200_motels_(soundtrack)
mtv_unplugged_(ricky_martin_album)	mtv_unplugged_(ricky_martin_album)
port_royal_(album)	port_royal_(album)
moto_grosso_feio	moto_grosso_feio
moto_grosso_feio	odyssey_of_iska
always_with_us	always_with_us
under_a_blood_red_sky	under_a_blood_red_sky
it's_morrissey,_man!	it's_morrissey,_man!
last_scream_of_the_missing_neighbors	last_scream_of_the_missing_neighbors
friendly_bacteria	friendly_bacteria
...and_justice_for_all_(album)	...and_justice_for_all_(album)
greatest_hits_(luther_vandross_album)	greatest_hits_(luther_vandross_album)
new_light_through_old_windows	new_light_through_old_windows
upside_down_mountain	upside_down_mountain
invisible_lantern	invisible_lantern
the_inner_mounting_flame	the_inner_mounting_flame
bill_evans_at_town_hall	bill_evans_at_town_hall
emmaar	emmaar
g.i.t._on_broadway	g.i.t._on_broadway
extreme_honey	extreme_honey
above_(samael_album)	above_(samael_album)
christmas_time's_a-comin'_(album)	christmas_time's_a-comin'_(album)
time_doesn't_heal	time_doesn't_heal
a_collection_of_hits	a_collection_of_hits
live_at_the_isle_of_wight_festival_1970_(the_who_album)	live_at_the_isle_of_wight_festival_1970_(the_who_album)
munich_(soundtrack)	munich_(soundtrack)
see_you_up_there	see_you_up_there
live_at_massey_hall_1971	live_at_massey_hall_1971
one_man_dog	one_man_dog
survive_(nuclear_assault_album)	survive_(nuclear_assault_album)
in_the_hollies_style	in_the_hollies_style
i_never_learn	i_never_learn
meeting_in_the_ladies_room	meeting_in_the_ladies_room
tora_no_ana	tora_no_ana
the_electrifying_aretha_franklin	the_electrifying_aretha_franklin
my_generation_(album)	my_generation_(album)
raivo_(album)	raivo_(album)
