dokkyo_medical_university	dokkyo_medical_university
central_american_university_(managua)	central_american_university_(managua)
jewish_theological_seminary_of_america	jewish_theological_seminary_of_america
dr._ambedkar_government_law_college,_chennai	dr._ambedkar_government_law_college,_chennai
central_south_university	central_south_university
university_of_rajasthan	university_of_rajasthan
goizueta_business_school	goizueta_business_school
owen_graduate_school_of_management	owen_graduate_school_of_management
gallaudet_university	gallaudet_university
vancouver_island_university	vancouver_island_university
dow_university_of_health_sciences	dow_university_of_health_sciences
nanyang_technological_university	nanyang_technological_university
st._joseph's_college,_bangalore	st._joseph's_college,_bangalore
lappeenranta_university_of_technology	lappeenranta_university_of_technology
tennessee_temple_university	tennessee_temple_university
hemchandracharya_north_gujarat_university	hemchandracharya_north_gujarat_university
illinois_wesleyan_university	illinois_wesleyan_university
southern_methodist_university	southern_methodist_university
middlebury_college	middlebury_college
carleton_university	carleton_university
amrita_school_of_engineering	amrita_school_of_engineering
mohammad_ali_jinnah_university	mohammad_ali_jinnah_university
brac_university	brac_university
allegheny_college	allegheny_college
western_carolina_university	western_carolina_university
assam_engineering_college	assam_engineering_college
university_of_aberdeen	university_of_aberdeen
graphic_era_university	graphic_era_university
shaheed_sukhdev_college_of_business_studies	shaheed_sukhdev_college_of_business_studies
philippine_college_of_health_sciences,_inc.	philippine_college_of_health_sciences,_inc.
indira_gandhi_national_open_university	indira_gandhi_national_open_university
kansas_wesleyan_university	kansas_wesleyan_university
de_la_salle_university	de_la_salle_university
university_of_west_georgia	university_of_west_georgia
hillsdale_college	hillsdale_college
kobe_university	kobe_university
escp_europe	escp_europe
rabbinical_college_of_canada	rabbinical_college_of_canada
uitm_faculty_of_law	uitm_faculty_of_law
shenyang_pharmaceutical_university	shenyang_pharmaceutical_university
thomas_more_college_of_liberal_arts	thomas_more_college_of_liberal_arts
american_baptist_college	american_baptist_college
university_of_seychelles	university_of_seychelles
indian_institute_of_management_bangalore	indian_institute_of_management_bangalore
tufts_university	tufts_university
cumberland_university	cumberland_university
vestfold_university_college	vestfold_university_college
lahore_university_of_management_sciences	lahore_university_of_management_sciences
king's_university_college_(university_of_western_ontario)	king's_university_college_(university_of_western_ontario)
missouri_valley_college	missouri_valley_college
university_of_groningen	university_of_groningen
montclair_state_university	montclair_state_university
fluminense_federal_university	fluminense_federal_university
tomsk_state_university	tomsk_state_university
hebrew_university_of_jerusalem	hebrew_university_of_jerusalem
london_college_of_communication	london_college_of_communication
azusa_pacific_university	azusa_pacific_university
indian_academy_of_sciences	indian_academy_of_sciences
rhine-waal_university_of_applied_sciences	rhine-waal_university_of_applied_sciences
amguri_college	amguri_college
lutheran_university_of_applied_sciences_nuremberg	lutheran_university_of_applied_sciences_nuremberg
american_academy_of_dramatic_arts	american_academy_of_dramatic_arts
harbin_institute_of_technology	harbin_institute_of_technology
alderson_broaddus_university	alderson_broaddus_university
university_of_the_punjab	university_of_the_punjab
milwaukee_school_of_engineering	milwaukee_school_of_engineering
riverland_community_college	riverland_community_college
western_michigan_university	western_michigan_university
swinburne_university_of_technology	swinburne_university_of_technology
presbyterian_college	presbyterian_college
leonardo_da_vinci_engineering_school	leonardo_da_vinci_engineering_school
indian_institute_of_management_calcutta	indian_institute_of_management_calcutta
laidlaw_college	laidlaw_college
morgridge_college_of_education	morgridge_college_of_education
international_school_for_advanced_studies	international_school_for_advanced_studies
university_of_strathclyde	university_of_strathclyde
university_of_georgia_college_of_veterinary_medicine	university_of_georgia_college_of_veterinary_medicine
ruaha_university_college	ruaha_university_college
nicolet_area_technical_college	nicolet_area_technical_college
macalester_college	macalester_college
tanta_university	tanta_university
indian_institute_of_technology_bombay	indian_institute_of_technology_bombay
austral_university_of_chile	austral_university_of_chile
elizabeth_city_state_university	elizabeth_city_state_university
university_of_aleppo	university_of_aleppo
university_of_san_carlos	university_of_san_carlos
north_idaho_college	north_idaho_college
kyonggi_university	kyonggi_university
jawaharlal_nehru_centre_for_advanced_scientific_research	jawaharlal_nehru_centre_for_advanced_scientific_research
vancouver_school_of_theology	vancouver_school_of_theology
momoyama_gakuin_university	momoyama_gakuin_university
mzumbe_university	mzumbe_university
jamia_nizamia	jamia_nizamia
the_catholic_university_of_america	the_catholic_university_of_america
university_of_melbourne	university_of_melbourne
grand_view_university	grand_view_university
air_war_college	air_war_college
california_state_university,_stanislaus	california_state_university,_stanislaus
ukrainian_medical_stomatological_academy	ukrainian_medical_stomatological_academy
tokyo_woman's_christian_university	tokyo_woman's_christian_university
telecom_business_school	telecom_business_school
eastern_arizona_college	eastern_arizona_college
tusculum_college	tusculum_college
brahmananda_keshab_chandra_college	brahmananda_keshab_chandra_college
regional_cancer_centre,_thiruvananthapuram	regional_cancer_centre,_thiruvananthapuram
colorado_college	colorado_college
adarsh_polytechnic	adarsh_polytechnic
nell_hodgson_woodruff_school_of_nursing	nell_hodgson_woodruff_school_of_nursing
visva-bharati_university	visva-bharati_university
indian_institute_of_management_lucknow	indian_institute_of_management_lucknow
california_college_of_the_arts	california_college_of_the_arts
michigan_state_university	michigan_state_university
university_of_misan	university_of_misan
st._olaf_college	st._olaf_college
schechter_institute_of_jewish_studies	schechter_institute_of_jewish_studies
athabasca_university	athabasca_university
national_institute_of_arts,_kinshasa	national_institute_of_arts,_kinshasa
southern_new_hampshire_university	southern_new_hampshire_university
dallas_theological_seminary	dallas_theological_seminary
koya_university	koya_university
university_of_east_london	university_of_east_london
charleston_school_of_law	charleston_school_of_law
lund_university	lund_university
barton_college	barton_college
national_theatre_school_of_canada	national_theatre_school_of_canada
university_of_hyderabad	university_of_hyderabad
university_of_lucknow	university_of_lucknow
glendon_college	glendon_college
kandahar_university	kandahar_university
asbury_university	asbury_university
lalbhai_dalpatbhai_college_of_engineering	lalbhai_dalpatbhai_college_of_engineering
university_of_sri_jayewardenepura	university_of_sri_jayewardenepura
university_of_angers	university_of_angers
vardhman_mahavir_medical_college	vardhman_mahavir_medical_college
columbia_bible_college	columbia_bible_college
university_of_santo_tomas	university_of_santo_tomas
oberlin_college	oberlin_college
hamdard_university	hamdard_university
roanoke_college	roanoke_college
indiana_state_university	indiana_state_university
govind_ballabh_pant_engineering_college	govind_ballabh_pant_engineering_college
fairmont_state_university	fairmont_state_university
colorado_state_university	colorado_state_university
bicol_university	bicol_university
curry_college	curry_college
university_of_zululand	university_of_zululand
university_of_dundee	university_of_dundee
indiana_university_bloomington	indiana_university_bloomington
university_of_texas_at_austin	university_of_texas_at_austin
central_academy_of_drama	central_academy_of_drama
sher-e-bangla_agricultural_university	sher-e-bangla_agricultural_university
american_baptist_seminary_of_the_west	american_baptist_seminary_of_the_west
assam_university	assam_university
council_of_ontario_universities	council_of_ontario_universities
university_of_georgia_graduate_school	university_of_georgia_graduate_school
hunter_college	hunter_college
acharya_n._g._ranga_agricultural_university	acharya_n._g._ranga_agricultural_university
doc_film_institute	doc_film_institute
qafqaz_university	qafqaz_university
college_of_engineering,_trivandrum	college_of_engineering,_trivandrum
centenary_college_of_new_jersey	centenary_college_of_new_jersey
jean_moulin_university_lyon_3	jean_moulin_university_lyon_3
nanjing_normal_university	nanjing_normal_university
university_of_louisiana_at_lafayette	university_of_louisiana_at_lafayette
ie_university	ie_university
coastal_carolina_university	coastal_carolina_university
institute_of_management_technology,_ghaziabad	institute_of_management_technology,_ghaziabad
ewha_womans_university	ewha_womans_university
indiana_university_of_pennsylvania	indiana_university_of_pennsylvania
washington_college	washington_college
national_institute_of_technology,_warangal	national_institute_of_technology,_warangal
drama_studio_london	drama_studio_london
lille_catholic_university	lille_catholic_university
columbia_university_school_of_social_work	columbia_university_school_of_social_work
winston-salem_state_university	winston-salem_state_university
belmont_abbey_college	belmont_abbey_college
reitaku_university	reitaku_university
zayed_university	zayed_university
keck_school_of_medicine_of_usc	keck_school_of_medicine_of_usc
rotterdam_business_school	rotterdam_business_school
tecnun	tecnun
university_of_georgia	university_of_georgia
hec_lausanne	hec_lausanne
tennessee_college_of_applied_technology_-_pulaski	tennessee_college_of_applied_technology_-_pulaski
the_art_institute_of_salt_lake_city	the_art_institute_of_salt_lake_city
university_of_oslo	university_of_oslo
banasthali_vidyapith	banasthali_vidyapith
william_howard_taft_university	william_howard_taft_university
national_university_of_la_plata	national_university_of_la_plata
humphreys_college	humphreys_college
syiah_kuala_university	syiah_kuala_university
karunya_university	karunya_university
apollos_university	apollos_university
butler_university	butler_university
china-eu_school_of_law	china-eu_school_of_law
el_camino_college	el_camino_college
francisco_de_paula_santander_university	francisco_de_paula_santander_university
dar_al-uloom_colleges	dar_al-uloom_colleges
howard_community_college	howard_community_college
st._petersburg_college	st._petersburg_college
aoyama_gakuin_university	aoyama_gakuin_university
cuyamaca_college	cuyamaca_college
chettinad_vidyashram	chettinad_vidyashram
jacobs_university_bremen	jacobs_university_bremen
cornell_college	cornell_college
pontifical_catholic_university_of_chile	pontifical_catholic_university_of_chile
university_of_pretoria	university_of_pretoria
birla_high_school	birla_high_school
st._berchmans_college	st._berchmans_college
palm_beach_atlantic_university	palm_beach_atlantic_university
chinese_university_of_hong_kong	chinese_university_of_hong_kong
grove_city_college	grove_city_college
holy_child_catholic_school	holy_child_catholic_school
ball_state_university	ball_state_university
aichi_gakuin_university	aichi_gakuin_university
jagannath_university	jagannath_university
post_graduate_programme_for_executives_for_visionary_leadership_in_manufacturing_(pgpex-vlm)	post_graduate_programme_for_executives_for_visionary_leadership_in_manufacturing_(pgpex-vlm)
nirmala_college_for_women	university_law_college,_bangalore
nalanda_university	nalanda_university
danube_university_krems	danube_university_krems
tulane_university	tulane_university
arizona_state_university	arizona_state_university
mcgill_university	mcgill_university
johnson-shoyama_graduate_school_of_public_policy	johnson-shoyama_graduate_school_of_public_policy
grossmont_college	grossmont_college
osaka_university_of_foreign_studies	osaka_university_of_foreign_studies
muhammadiyah_university_of_magelang	muhammadiyah_university_of_magelang
de_la_salle_philippines	de_la_salle_philippines
northern_illinois_university	northern_illinois_university
free_university_of_ireland	free_university_of_ireland
leading_university	leading_university
hope_college	hope_college
silpakorn_university	silpakorn_university
university_of_washington	university_of_washington
university_of_konstanz	university_of_konstanz
university_of_cundinamarca	university_of_cundinamarca
magadh_university	magadh_university
vilnius_academy_of_arts	vilnius_academy_of_arts
university_of_vermont	university_of_vermont
university_of_bologna	university_of_bologna
north_carolina_central_university	north_carolina_central_university
aichi_shukutoku_university	aichi_shukutoku_university
hasanuddin_university	hasanuddin_university
florida_southern_college	florida_southern_college
hongik_university	hongik_university
presidency_university,_kolkata	presidency_university,_kolkata
muw_alumni_association	muw_alumni_association
virginia_wesleyan_college	virginia_wesleyan_college
liverpool_school_of_tropical_medicine	liverpool_school_of_tropical_medicine
australian_college_of_theology	australian_college_of_theology
mcneese_state_university	mcneese_state_university
berlin_graduate_school_for_transnational_studies	berlin_graduate_school_for_transnational_studies
prairie_view_a&m_university	prairie_view_a&m_university
ivy_bridge_college	ivy_bridge_college
vilnius_university	vilnius_university
east_asia_school_of_theology	east_asia_school_of_theology
soas,_university_of_london	soas,_university_of_london
st._angela's_college,_sligo	st._angela's_college,_sligo
khazar_university	khazar_university
university_of_guelph	innis_college,_toronto
university_of_guelph	red_deer_college
university_of_guelph	university_of_toronto_scarborough
university_of_guelph	university_of_guelph
university_of_guelph	brock_university
imperial_college_london	imperial_college_london
korea_university	korea_university
port_said_university	port_said_university
university_of_applied_sciences_offenburg	university_of_applied_sciences_offenburg
university_of_mysore	university_of_mysore
life_university	life_university
government_law_college,_mumbai	government_law_college,_mumbai
university_of_manchester	university_of_manchester
kumasi_polytechnic	kumasi_polytechnic
gordon_college_(massachusetts)	gordon_college_(massachusetts)
chang_jung_christian_university	chang_jung_christian_university
pennsylvania_state_university	pennsylvania_state_university
university_of_szeged	university_of_szeged
wharton_school_of_the_university_of_pennsylvania	wharton_school_of_the_university_of_pennsylvania
jamia_millia_islamia	jamia_millia_islamia
agricultural_university_of_tirana	agricultural_university_of_tirana
manhattan_school_of_music	manhattan_school_of_music
university_of_douai	university_of_douai
lithuanian_sports_university	lithuanian_sports_university
aichi_university	aichi_university
baruch_college	baruch_college
university_of_washington_school_of_drama	university_of_washington_school_of_drama
european_school_of_economics	european_school_of_economics
university_of_moratuwa	university_of_moratuwa
university_of_mobile	university_of_mobile
northeast_mississippi_community_college	northeast_mississippi_community_college
macquarie_university	macquarie_university
covenant_theological_seminary	covenant_theological_seminary
university_of_saint_mary	university_of_saint_mary
universitas_kristen_indonesia	universitas_kristen_indonesia
madras_medical_college	madras_medical_college
dordt_college	dordt_college
anderson_university_(indiana)	anderson_university_(indiana)
bond_university	bond_university
juraj_dobrila_university_of_pula	juraj_dobrila_university_of_pula
mater_dei_institute_of_education	mater_dei_institute_of_education
pacific_school_of_religion	pacific_school_of_religion
university_of_sharjah	university_of_sharjah
college_of_saint_elizabeth	college_of_saint_elizabeth
harvey_mudd_college	harvey_mudd_college
community_college_of_vermont	community_college_of_vermont
university_of_development_alternative	university_of_development_alternative
zanzibar_university	zanzibar_university
faculty_of_architecture,_university_of_zagreb	university_of_zagreb
canadian_international_college	canadian_international_college
sul_ross_state_university	sul_ross_state_university
academy_of_sciences_of_the_czech_republic	academy_of_sciences_of_the_czech_republic
dedan_kimathi_university_of_technology	dedan_kimathi_university_of_technology
university_of_twente	university_of_twente
kyoto_institute_of_technology	kyoto_institute_of_technology
bemidji_state_university	bemidji_state_university
nesna_university_college	nesna_university_college
central_washington_university	central_washington_university
midwestern_state_university	midwestern_state_university
mount_mary_university	mount_mary_university
depaul_university	depaul_university
virginia_tech	virginia_tech
wabash_college	wabash_college
regional_maritime_university	regional_maritime_university
okanagan_college	okanagan_college
university_of_houston	university_of_houston
swinburne_residential_college	swinburne_residential_college
temple_university	temple_university
st._francis'_college	st._francis'_college
parkwood_school_international	parkwood_school_international
ardhi_university	ardhi_university
portland_state_university	portland_state_university
east_tennessee_state_university	east_tennessee_state_university
fontys_university_of_applied_sciences	fontys_university_of_applied_sciences
john_wesley_college	john_wesley_college
taras_shevchenko_national_university_of_kyiv	taras_shevchenko_national_university_of_kyiv
iowa_central_community_college	iowa_central_community_college
kyoto_university	kyoto_university
harvard_business_school	harvard_business_school
karlsruhe_university_of_applied_sciences	karlsruhe_university_of_applied_sciences
leeds_university_business_school	leeds_university_business_school
wheaton_college_(massachusetts)	wheaton_college_(massachusetts)
university_of_ceylon	university_of_ceylon
yong_in_university	yong_in_university
boston_university	boston_university
universidad_la_salle	universidad_la_salle
national_institute_of_development_administration	national_institute_of_development_administration
columbia_international_university	columbia_international_university
university_of_madras	university_of_madras
lincoln_memorial_university	lincoln_memorial_university
humboldt_university_of_berlin	humboldt_university_of_berlin
rcc_institute_of_technology	rcc_institute_of_technology
mary_baldwin_college	mary_baldwin_college
buena_vista_university	buena_vista_university
savannah_state_university	savannah_state_university
tunku_abdul_rahman_university_college	tunku_abdul_rahman_university_college
royal_academy_of_music	royal_academy_of_music
university_of_maryland,_baltimore_county	university_of_maryland,_baltimore_county
rider_university	rider_university
university_of_gothenburg	university_of_gothenburg
coppin_state_university	coppin_state_university
saint_francis_university	saint_francis_university
al-azhar_university	al-azhar_university
los_angeles_pierce_college	los_angeles_pierce_college
vytautas_magnus_university	vytautas_magnus_university
leipzig_university	leipzig_university
university_of_tennessee_at_chattanooga	university_of_tennessee_at_chattanooga
university_of_phoenix	university_of_phoenix
arcadia_university	arcadia_university
central_bible_college	central_bible_college
paris_12_val_de_marne_university	paris_12_val_de_marne_university
shanghai_conservatory_of_music	shanghai_conservatory_of_music
nagoya_keizai_university	nagoya_keizai_university
pearl_academy	pearl_academy
university_of_sacramento	university_of_sacramento
bennington_college	bennington_college
konan_university	konan_university
university_of_st._gallen	university_of_st._gallen
gujarat_university	gujarat_university
xinjiang_medical_university	xinjiang_medical_university
university_of_miami	university_of_miami
adventist_university_of_africa	adventist_university_of_africa
texas_wesleyan_university	texas_wesleyan_university
maulana_azad_college	maulana_azad_college
university_of_massachusetts_boston	university_of_massachusetts_boston
studio_58	studio_58
republic_polytechnic	republic_polytechnic
concordia_university_wisconsin	concordia_university_wisconsin
westminster_theological_seminary	westminster_theological_seminary
chung_yuan_christian_university	chung_yuan_christian_university
trinity_western_university	trinity_western_university
capella_university	capella_university
paul_quinn_college	paul_quinn_college
memorial_university_of_newfoundland	memorial_university_of_newfoundland
university_of_worcester	university_of_worcester
university_of_calicut	university_of_calicut
national_university_of_ireland	national_university_of_ireland
cambridge_judge_business_school	cambridge_judge_business_school
shaheed_mohtarma_benazir_bhutto_medical_university	shaheed_mohtarma_benazir_bhutto_medical_university
jan_van_eyck_academie	jan_van_eyck_academie
kansas_state_university	kansas_state_university
adams_state_university	adams_state_university
eindhoven_university_of_technology	eindhoven_university_of_technology
benadir_university	benadir_university
azerbaijan_technical_university	azerbaijan_technical_university
university_of_augsburg	university_of_augsburg
m._s._ramaiah_institute_of_technology	m._s._ramaiah_institute_of_technology
university_of_dallas	university_of_dallas
patriot_bible_university	patriot_bible_university
northeast_wisconsin_technical_college	northeast_wisconsin_technical_college
loyola_marymount_university	loyola_marymount_university
afi_conservatory	afi_conservatory
amsterdam_university_college	amsterdam_university_college
paris_dauphine_university	paris_dauphine_university
colegio_de_san_juan_de_letran	colegio_de_san_juan_de_letran
anhui_university_of_technology	anhui_university_of_technology
jianghan_university	jianghan_university
nanjing_medical_university	nanjing_medical_university
emerson_college	emerson_college
james_cook_university	james_cook_university
nancy_2_university	nancy_2_university
nikan_high_school	nikan_high_school
west_liberty_university	west_liberty_university
anhui_university	anhui_university
university_of_hanover	university_of_hanover
pontifical_university_antonianum	pontifical_university_antonianum
maranatha_baptist_university	maranatha_baptist_university
royal_veterinary_college	royal_veterinary_college
manipal_college_of_dental_sciences,_manipal	manipal_college_of_dental_sciences,_manipal
university_of_iowa_college_of_law	university_of_iowa_college_of_law
university_of_western_states	university_of_western_states
rizal_technological_university	rizal_technological_university
swami_shraddhanand_college,_university_of_delhi	swami_shraddhanand_college,_university_of_delhi
aichi_kiwami_college_of_nursing	aichi_kiwami_college_of_nursing
king_university	king_university
san_jose_state_university	san_jose_state_university
metropolitan_state_university_of_denver	metropolitan_state_university_of_denver
university_of_north_florida	university_of_north_florida
geneva_college	geneva_college
university_of_peradeniya	university_of_peradeniya
meiji_university	meiji_university
ahmadu_bello_university	ahmadu_bello_university
taylor_university	taylor_university
west_texas_a&m_university	west_texas_a&m_university
tianjin_university	tianjin_university
university_of_texas_at_arlington	university_of_texas_at_arlington
central_institute_for_correctional_police	central_institute_for_correctional_police
nalsar_university_of_law	nalsar_university_of_law
lipscomb_university	lipscomb_university
gonzaga_university	gonzaga_university
husson_university	husson_university
nagoya_management_junior_college	nagoya_management_junior_college
universidade_do_vale_do_rio_dos_sinos	universidade_do_vale_do_rio_dos_sinos
university_of_massachusetts_lowell	university_of_massachusetts_lowell
california_lutheran_university	california_lutheran_university
kremenchuk_flight_college_of_national_aviation_university	kremenchuk_flight_college_of_national_aviation_university
aichi_institute_of_technology	aichi_institute_of_technology
california_southern_university	california_southern_university
adithya_institute_of_technology	adithya_institute_of_technology
ateneo_de_davao_university	ateneo_de_davao_university
chalmers_lindholmen_university_college	chalmers_lindholmen_university_college
mckendree_university	mckendree_university
patna_university	patna_university
new_college_of_california	new_college_of_california
arizona_state_university_at_the_polytechnic_campus	arizona_state_university_at_the_polytechnic_campus
dodge_city_community_college	dodge_city_community_college
indian_school_of_business	indian_school_of_business
utah_valley_university	utah_valley_university
complutense_university_of_madrid	complutense_university_of_madrid
singapore_institute_of_management	singapore_institute_of_management
hawler_medical_university	hawler_medical_university
motilal_nehru_national_institute_of_technology_allahabad	motilal_nehru_national_institute_of_technology_allahabad
suez_canal_university	suez_canal_university
new_england_college	new_england_college
central_european_university	central_european_university
maharaja_surajmal_institute_of_technology	maharaja_surajmal_institute_of_technology
colegio_de_san_lorenzo	colegio_de_san_lorenzo
st._augustine's_university	st._augustine's_university
manchester_metropolitan_university	manchester_metropolitan_university
university_of_calgary	mohawk_college
university_of_calgary	centennial_college
university_of_calgary	university_of_calgary
sit_graduate_institute	sit_graduate_institute
central_michigan_university	central_michigan_university
california_state_university,_northridge	california_state_university,_northridge
beijing_university_of_technology	beijing_university_of_technology
multnomah_university	multnomah_university
california_state_university,_bakersfield	california_state_university,_bakersfield
mcpherson_college	mcpherson_college
kalayaan_college	kalayaan_college
jones_international_university	jones_international_university
sherman_college_of_chiropractic	sherman_college_of_chiropractic
american_university_of_beirut	american_university_of_beirut
chungwoon_university	chungwoon_university
amoud_university	amoud_university
de_anza_college	de_anza_college
pakistan_pharmacists_association	pakistan_pharmacists_association
st._john's_university_of_tanzania	st._john's_university_of_tanzania
appalachian_state_university	appalachian_state_university
st_mary's_university,_twickenham	st_mary's_university,_twickenham
st._norbert_college	st._norbert_college
lincoln_university_(pennsylvania)	lincoln_university_(pennsylvania)
southeastern_louisiana_university	southeastern_louisiana_university
shanto-mariam_university_of_creative_technology	shanto-mariam_university_of_creative_technology
liberty_university	liberty_university
anoka_technical_college	anoka_technical_college
northern_arizona_university	northern_arizona_university
shivaji_university	shivaji_university
jawaharlal_nehru_technological_university,_hyderabad	jawaharlal_nehru_technological_university,_hyderabad
aichi_bunkyo_university	aichi_bunkyo_university
university_of_the_fraser_valley	university_of_the_fraser_valley
university_of_applied_sciences_bingen	university_of_applied_sciences_bingen
faculty_of_law,_thammasat_university	faculty_of_law,_thammasat_university
university_of_antwerp	university_of_antwerp
university_of_advancing_technology	university_of_advancing_technology
university_of_bucharest	university_of_bucharest
wisconsin_school_of_business	wisconsin_school_of_business
sree_vidyanikethan_engineering_college	sree_vidyanikethan_engineering_college
huafan_university	huafan_university
guilin_medical_university	guilin_medical_university
columbia_theological_seminary	columbia_theological_seminary
sindh_muslim_law_college	sindh_muslim_law_college
university_of_southern_denmark	university_of_southern_denmark
berlin_mathematical_school	berlin_mathematical_school
kastamonu_university	kastamonu_university
universitas_terbuka	universitas_terbuka
university_of_new_south_wales	university_of_new_south_wales
chinese_culture_university	chinese_culture_university
waikato_institute_of_technology	waikato_institute_of_technology
ite_college_central	ite_college_central
university_of_manitoba	university_of_manitoba
regensburg_university_of_applied_sciences	regensburg_university_of_applied_sciences
united_states_air_force_academy	united_states_air_force_academy
union_presbyterian_seminary	union_presbyterian_seminary
daniel_webster_college	daniel_webster_college
university_of_sri_lanka	university_of_sri_lanka
mount_st._mary's_university	mount_st._mary's_university
al_jamea_tus_saifiyah	al_jamea_tus_saifiyah
west_virginia_wesleyan_college	west_virginia_wesleyan_college
east_stroudsburg_university_of_pennsylvania	east_stroudsburg_university_of_pennsylvania
university_of_salford	university_of_salford
syms_school_of_business	syms_school_of_business
ucl_school_of_pharmacy	ucl_school_of_pharmacy
colorado_technical_university	colorado_technical_university
harvard_university	harvard_university
harvard_university	harvard_graduate_school_of_design
harvard_university	harvard_medical_school
harvard_university	harvard_divinity_school
alexandria_university	alexandria_university
vitebsk_state_technological_university	vitebsk_state_technological_university
collegium_civitas	collegium_civitas
first_nations_university_of_canada	first_nations_university_of_canada
georgia_southern_university	georgia_southern_university
heliopolis_university	heliopolis_university
university_of_padua	university_of_padua
texas_christian_university	texas_christian_university
manuel_l._quezon_university	manuel_l._quezon_university
dublin_city_university	dublin_city_university
international_institute_of_information_technology,_bangalore	international_institute_of_information_technology,_bangalore
siberian_state_aerospace_university	siberian_state_aerospace_university
sree_kerala_varma_college	sree_kerala_varma_college
christopher_newport_university	christopher_newport_university
florida_a&m_university	florida_a&m_university
drexel_university	drexel_university
athens_school_of_fine_arts	athens_school_of_fine_arts
university_of_vienna	university_of_vienna
leeds_school_of_medicine	leeds_school_of_medicine
university_of_north_texas	university_of_north_texas
konstfack	konstfack
university_of_navarra	university_of_navarra
sam_houston_state_university	sam_houston_state_university
indian_institute_of_science	indian_institute_of_science
beykent_university	beykent_university
midlands_technical_college	midlands_technical_college
university_of_utah_school_of_medicine	university_of_utah
daido_university	daido_university
nagoya_bunri_university	nagoya_bunri_university
university_of_copenhagen	university_of_copenhagen
university_of_oxford	university_of_oxford
camp_eagle_ridge	camp_eagle_ridge
comilla_university	comilla_university
birkbeck,_university_of_london	birkbeck,_university_of_london
lawrence_technological_university	lawrence_technological_university
cept_university	cept_university
valencia_college	valencia_college
laurentian_university	laurentian_university
haverford_college	haverford_college
ptpl_college	ptpl_college
university_of_pittsburgh_honors_college	university_of_pittsburgh_honors_college
rosemont_college	rosemont_college
qut_business_school	qut_business_school
bryant_university	bryant_university
university_of_the_ryukyus	university_of_the_ryukyus
barnard_college	barnard_college
seoul_institute_of_the_arts	seoul_institute_of_the_arts
lehigh_university	lehigh_university
william_paterson_university	william_paterson_university
albion_college	albion_college
vanderbilt_university_school_of_engineering	vanderbilt_university_school_of_engineering
princess_sumaya_university_for_technology	princess_sumaya_university_for_technology
iowa_state_university	iowa_state_university
aga_khan_university	aga_khan_university
we_school	we_school
southern_utah_university	southern_utah_university
london_south_bank_university	london_south_bank_university
beloit_college	beloit_college
university_of_tokushima	university_of_tokushima
kisii_school	kisii_school
cambridge_college	cambridge_college
montgomery_college	montgomery_college
university_of_pennsylvania_school_of_nursing	university_of_pennsylvania_school_of_nursing
winona_state_university	winona_state_university
national_university_of_rosario	national_university_of_rosario
colorado_northwestern_community_college	colorado_northwestern_community_college
university_of_san_francisco	university_of_san_francisco
sokoine_university_of_agriculture	sokoine_university_of_agriculture
cardiff_metropolitan_university	cardiff_metropolitan_university
melbourne_institute_of_technology	melbourne_institute_of_technology
haskell_indian_nations_university	haskell_indian_nations_university
la_trobe_university	la_trobe_university
keio_university	keio_university
university_of_northern_british_columbia	university_of_northern_british_columbia
navsari_agricultural_university	navsari_agricultural_university
aichi_konan_college	aichi_konan_college
university_of_minnesota_duluth	university_of_minnesota_duluth
knox_college_(illinois)	knox_college_(illinois)
school_of_petroleum_technology	school_of_petroleum_technology
musashino_academia_musicae	musashino_academia_musicae
des_moines_university	des_moines_university
vienna_university_of_technology	vienna_university_of_technology
chaudhary_charan_singh_university	chaudhary_charan_singh_university
alpena_community_college	alpena_community_college
villanova_university_school_of_law	villanova_university_school_of_law
mogadishu_university	mogadishu_university
aichi_university_of_technology	aichi_university_of_technology
manipal_university	manipal_university
national_institute_of_fashion_technology	national_institute_of_fashion_technology
catawba_college	catawba_college
el_camino_college_compton_center	el_camino_college_compton_center
autonomous_university_of_carmen	autonomous_university_of_carmen
drama_centre_london	drama_centre_london
aurora_college	aurora_college
university_of_kitakyushu	university_of_kitakyushu
gadjah_mada_university	gadjah_mada_university
polytechnic_university_of_the_philippines	polytechnic_university_of_the_philippines
university_of_wales	university_of_wales
bow_valley_college	bow_valley_college
parsons_college	parsons_college
technical_university_of_denmark	technical_university_of_denmark
cergy-pontoise_university	cergy-pontoise_university
university_of_wales,_lampeter	university_of_wales,_lampeter
alabama_state_university	alabama_state_university
pitzer_college	pitzer_college
seattle_pacific_university	seattle_pacific_university
manipur_university	manipur_university
gulf_medical_university	gulf_medical_university
polk_state_college	polk_state_college
utrecht_university	university_college_utrecht
utrecht_university	utrecht_university
texas_woman's_university	texas_woman's_university
grand_canyon_university	grand_canyon_university
islamic_university_of_technology	islamic_university_of_technology
virginia_military_institute	virginia_military_institute
hanyang_university	hanyang_university
university_of_chittagong	university_of_chittagong
transvaal_university_college	transvaal_university_college
auburn_university	auburn_university
northwestern_university	northwestern_university
purdue_university	purdue_university
san_diego_state_university	san_diego_state_university
university_of_tabriz	university_of_tabriz
norfolk_state_university	norfolk_state_university
institute_of_business_management	institute_of_business_management
kyung_hee_university	kyung_hee_university
international_islamic_university,_islamabad	international_islamic_university,_islamabad
french_university_in_egypt	french_university_in_egypt
midwestern_college	midwestern_college
national_university_of_modern_languages	national_university_of_modern_languages
indian_institute_of_technology_delhi	indian_institute_of_technology_delhi
st._ambrose_university	st._ambrose_university
perelman_school_of_medicine_at_the_university_of_pennsylvania	perelman_school_of_medicine_at_the_university_of_pennsylvania
calcutta_school_of_music	calcutta_school_of_music
pakistan_marine_academy	pakistan_marine_academy
olivet_college	olivet_college
michigan_technological_university	michigan_technological_university
university_college_dublin	university_college_dublin
university_of_the_incarnate_word	university_of_the_incarnate_word
moberly_area_community_college	moberly_area_community_college
sacred_heart_school_of_theology	sacred_heart_school_of_theology
saint_petersburg_state_university	saint_petersburg_state_university
shorter_university	shorter_university
kenya_methodist_university	kenya_methodist_university
montcalm_community_college	montcalm_community_college
western_kentucky_university	western_kentucky_university
university_of_east_africa	university_of_east_africa
zuyd_university_of_applied_sciences	zuyd_university_of_applied_sciences
miriam_college	miriam_college
high_point_university	high_point_university
fachhochschule_flensburg	fachhochschule_flensburg
boston_college	boston_college
universidad_iberoamericana	universidad_iberoamericana
arizona_christian_university	arizona_christian_university
barclay_college	barclay_college
pan_africa_christian_university	pan_africa_christian_university
k._k._das_college	k._k._das_college
kentucky_mountain_bible_college	kentucky_mountain_bible_college
west_virginia_university	west_virginia_university
wesleyan_college	wesleyan_college
baker_college	baker_college
texas_southern_university	texas_southern_university
stanford_graduate_school_of_business	stanford_graduate_school_of_business
loyola_university_chicago	college_of_dupage
munich_business_school	munich_business_school
marymount_california_university	marymount_california_university
university_of_szczecin	university_of_szczecin
washington_university_school_of_medicine	washington_university_school_of_medicine
fordham_graduate_school_of_social_service	fordham_graduate_school_of_social_service
missouri_state_university	missouri_state_university
st._john_international_university	st._john_international_university
springfield_technical_community_college	springfield_technical_community_college
university_of_illinois_at_springfield	university_of_illinois_at_springfield
robert_w._woodruff_library,_atlanta_university_center	robert_w._woodruff_library,_atlanta_university_center
paco_catholic_school	paco_catholic_school
munich_school_of_philosophy	munich_school_of_philosophy
paul_l._foster_school_of_medicine	paul_l._foster_school_of_medicine
carol_i_national_defence_university	carol_i_national_defence_university
peking_university	peking_university
moraine_valley_community_college	moraine_valley_community_college
ecwa_bingham_university	ecwa_bingham_university
the_hague_university_of_applied_sciences	the_hague_university_of_applied_sciences
sriwijaya_university	sriwijaya_university
central_agricultural_university	central_agricultural_university
university_of_pennsylvania_school_of_design	university_of_pennsylvania_school_of_design
iliff_school_of_theology	iliff_school_of_theology
university_of_makati	university_of_makati
john_tyler_community_college	john_tyler_community_college
guru_gobind_singh_indraprastha_university	guru_gobind_singh_indraprastha_university
missouri_western_state_university	missouri_western_state_university
patten_university	patten_university
canadian_memorial_chiropractic_college	canadian_memorial_chiropractic_college
beihang_university	beihang_university
semmelweis_university	semmelweis_university
panimalar_engineering_college	panimalar_engineering_college
university_of_applied_sciences_technikum_wien	university_of_applied_sciences_technikum_wien
bocconi_university	bocconi_university
tumkur_university	tumkur_university
selma_university	selma_university
chanakya_national_law_university	chanakya_national_law_university
university_of_leeds	university_of_leeds
indian_institute_of_technology_roorkee	indian_institute_of_technology_roorkee
rikkyo_university	rikkyo_university
university_of_tolima	university_of_tolima
humber_college	humber_college
aichi_prefectural_college_of_nursing_&_health	aichi_prefectural_college_of_nursing_&_health
tanza_national_comprehensive_high_school	tanza_national_comprehensive_high_school
s.n._bose_national_centre_for_basic_sciences	s.n._bose_national_centre_for_basic_sciences
kaunas_university_of_technology	kaunas_university_of_technology
lambuth_university	lambuth_university
university_ucinf	university_ucinf
chulachomklao_royal_military_academy	chulachomklao_royal_military_academy
delhi_school_of_economics	delhi_school_of_economics
university_of_prince_edward_island	university_of_prince_edward_island
middle_tennessee_state_university	middle_tennessee_state_university
al-madinah_international_university	al-madinah_international_university
doho_university	doho_university
university_of_fort_hare	university_of_fort_hare
university_of_sheffield	university_of_sheffield
alrafidain_university_college	alrafidain_university_college
north_greenville_university	north_greenville_university
paris-sorbonne_university	paris-sorbonne_university
nnamdi_azikiwe_university	nnamdi_azikiwe_university
rajarata_university_of_sri_lanka	rajarata_university_of_sri_lanka
moraine_park_technical_college	moraine_park_technical_college
university_of_batangas	university_of_batangas
lycoming_college	lycoming_college
jai_prakash_university	jai_prakash_university
dalhousie_university	dalhousie_university
mesa_community_college	mesa_community_college
belmont_university	belmont_university
seijoh_university	seijoh_university
university_of_jos	university_of_jos
st._john's_university,_shanghai	st._john's_university,_shanghai
serampore_college	serampore_college
anandamohan_college	anandamohan_college
dravidian_university	dravidian_university
university_of_southern_indiana	university_of_southern_indiana
pacific_states_university	pacific_states_university
upsala_college	upsala_college
epoka_university	epoka_university
baylor_college_of_medicine	baylor_college_of_medicine
university_of_tirana	university_of_tirana
black_mountain_college	black_mountain_college
bharat_institute_of_technology	bharat_institute_of_technology
university_of_minnesota	university_of_minnesota_duluth
nizhyn_gogol_state_university	nizhyn_gogol_state_university
bangladesh_university	bangladesh_university
pendekanti_law_college	pendekanti_law_college
east_los_angeles_college	east_los_angeles_college
bradley_university	bradley_university
university_of_british_columbia	university_of_british_columbia
louisiana_state_university	louisiana_state_university
shanghai_university	shanghai_university
university_of_huelva	university_of_huelva
american_river_college	american_river_college
monash_university_faculty_of_law	monash_university
syarif_hidayatullah_state_islamic_university_jakarta	syarif_hidayatullah_state_islamic_university_jakarta
dadabhoy_institute_of_higher_education	dadabhoy_institute_of_higher_education
university_of_north_carolina_at_asheville	university_of_north_carolina_at_asheville
duta_wacana_christian_university	duta_wacana_christian_university
nankai_university	nankai_university
allahabad_university	allahabad_university
kaohsiung_medical_university	kaohsiung_medical_university
saint_joseph_university	saint_joseph_university
san_beda_college	san_beda_college
foothill_college	foothill_college
guru_nanak_dev_university	guru_nanak_dev_university
holon_institute_of_technology	holon_institute_of_technology
petroleum_university_of_technology	petroleum_university_of_technology
harokopio_university	harokopio_university
jai_narain_vyas_university	jai_narain_vyas_university
university_of_guelph-humber	university_of_guelph-humber
maranatha_bible_school	maranatha_bible_school
ocad_university	ocad_university
khyber_medical_university	khyber_medical_university
deccan_college_of_medical_sciences	deccan_college_of_medical_sciences
new_york_city_college_of_technology	new_york_city_college_of_technology
johns_hopkins_university	johns_hopkins_university
chodang_university	chodang_university
university_of_mary_washington	university_of_mary_washington
mount_washington_college	mount_washington_college
university_of_piura	university_of_piura
adichunchanagiri_institute_of_technology	adichunchanagiri_institute_of_technology
point_loma_nazarene_university	point_loma_nazarene_university
university_of_memphis	university_of_memphis
university_of_the_witwatersrand	university_of_the_witwatersrand
california_state_university,_sacramento	california_state_university,_sacramento
malaysia_baptist_theological_seminary	malaysia_baptist_theological_seminary
noroff	noroff
national_louis_university	national_louis_university
university_of_mindanao	university_of_mindanao
k_l_university	k_l_university
national_institute_of_technology,_tiruchirappalli	national_institute_of_technology,_tiruchirappalli
southern_college_of_optometry	southern_college_of_optometry
fr._conceicao_rodrigues_college_of_engineering	fr._conceicao_rodrigues_college_of_engineering
united_nations_university_international_institute_for_software_technology	united_nations_university_international_institute_for_software_technology
south_ural_state_university	south_ural_state_university
college_of_william_&_mary	college_of_william_&_mary
morehouse_school_of_medicine	morehouse_school_of_medicine
dokkyo_university	dokkyo_university
kuvempu_university	kuvempu_university
pakistan_navy_engineering_college	pakistan_navy_engineering_college
cesar_ritz_colleges	cesar_ritz_colleges
aberystwyth_university	aberystwyth_university
cape_cod_community_college	cape_cod_community_college
penang_free_school	penang_free_school
california_community_colleges_system	california_community_colleges_system
university_of_virginia	university_of_richmond
university_of_virginia	university_of_virginia
kadena_high_school	kadena_high_school
seattle_university	seattle_university
asian_university	asian_university
royal_conservatory_of_brussels	royal_conservatory_of_brussels
langara_college	langara_college
istituto_europeo_di_design	istituto_europeo_di_design
brown_university	brown_university
institut_d'administration_des_entreprises	institut_d'administration_des_entreprises
independent_college_dublin	independent_college_dublin
shafston_college	shafston_college
tokyo_gakugei_university	tokyo_gakugei_university
beijing_university_of_chemical_technology	beijing_university_of_chemical_technology
garden_city_community_college	garden_city_community_college
st_george's,_university_of_london	st_george's,_university_of_london
hesston_college	hesston_college
moody_bible_institute	moody_bible_institute
brandon_university	brandon_university
meghnad_saha_institute_of_technology	meghnad_saha_institute_of_technology
raritan_valley_community_college	raritan_valley_community_college
university_of_tartu	university_of_tartu
fashion_institute_of_design_&_merchandising	fashion_institute_of_design_&_merchandising
fitchburg_state_university	fitchburg_state_university
hohai_university	hohai_university
jagiellonian_university	jagiellonian_university
college_of_engineering,_pune	college_of_engineering,_pune
university_of_mumbai	university_of_calcutta
university_of_mumbai	university_of_mumbai
northtec	northtec
federal_university_of_technology_akure	federal_university_of_technology_akure
university_of_east_asia	university_of_east_asia
stephen_f._austin_state_university	stephen_f._austin_state_university
international_school_of_bergen	international_school_of_bergen
harstad_university_college	harstad_university_college
eastleigh_college	eastleigh_college
mardan_institute_of_management_studies	mardan_institute_of_management_studies
south_texas_college_of_law	south_texas_college_of_law
brest_naval_training_centre	brest_naval_training_centre
management_development_institute_of_singapore	management_development_institute_of_singapore
wheaton_college_(illinois)	wheaton_college_(illinois)
china_pharmaceutical_university	china_pharmaceutical_university
aurora_university	aurora_university
kempten_university_of_applied_sciences	kempten_university_of_applied_sciences
rochester_institute_of_technology_croatia	rochester_institute_of_technology_croatia
china_agricultural_university	china_agricultural_university
bishop_westcott_boys'_school	bishop_westcott_boys'_school
emory_university	emory_university
campbell_university	campbell_university
renmin_university_of_china	renmin_university_of_china
southern_illinois_university_carbondale	southern_illinois_university_carbondale
lds_business_college	lds_business_college
fort_lewis_college	fort_lewis_college
shubun_university	shubun_university
providence_college	providence_college
s_p_jain_school_of_global_management	s_p_jain_school_of_global_management
sydney_medical_school	sydney_medical_school
university_college_lahore	university_college_lahore
central_gippsland_institute_of_tafe	central_gippsland_institute_of_tafe
birmingham_city_university	birmingham_city_university
university_of_montevallo	university_of_montevallo
bogor_agricultural_university	bogor_agricultural_university
school_of_engineering,_cusat	school_of_engineering,_cusat
georgia_institute_of_technology	georgia_institute_of_technology
christendom_college	christendom_college
chosun_university	chosun_university
karlshochschule_international_university	karlshochschule_international_university
university_of_northern_iowa	university_of_northern_iowa
california_state_university,_san_bernardino	california_state_university,_san_bernardino
university_of_south_carolina	university_of_south_carolina
georgia_southwestern_state_university	georgia_southwestern_state_university
new_york_theological_seminary	new_york_theological_seminary
duke_university	duke_university
university_of_indianapolis	university_of_indianapolis
university_of_victoria	university_of_victoria
randolph_college	randolph_college
university_of_pittsburgh	university_of_pittsburgh
williams_college	williams_college
kennesaw_state_university	kennesaw_state_university
queen_margaret_university,_asia_campus	queen_margaret_university,_asia_campus
vilnius_gediminas_technical_university	vilnius_gediminas_technical_university
john_cabot_university	john_cabot_university
sugiyama_jogakuen_university	sugiyama_jogakuen_university
ozarks_technical_community_college	ozarks_technical_community_college
truman_state_university	truman_state_university
san_francisco_state_university	san_francisco_state_university
university_of_technology,_iraq	university_of_technology,_iraq
university_of_portsmouth	university_of_portsmouth
austin_college	austin_college
jawaharlal_nehru_national_college_of_engineering	jawaharlal_nehru_national_college_of_engineering
whittier_college	whittier_college
collin_college	collin_college
regis_university	regis_university
concordia_university_texas	concordia_university_texas
mines_paristech	mines_paristech
berea_college	berea_college
singapore_institute_of_technology	singapore_institute_of_technology
virginia_intermont_college	virginia_intermont_college
millikin_university	millikin_university
osmania_medical_college	osmania_medical_college
german_historical_institute_in_rome	german_historical_institute_in_rome
brenau_university	brenau_university
georgia_military_college	georgia_military_college
jesuit_school_of_theology_of_santa_clara_university	jesuit_school_of_theology_of_santa_clara_university
waynesburg_university	waynesburg_university
jamia_nazmia	jamia_nazmia
southern_careers_institute	southern_careers_institute
illinois_state_university	illinois_state_university
nanyang_polytechnic	nanyang_polytechnic
athens_state_university	athens_state_university
milligan_college	milligan_college
northeast_state_community_college	northeast_state_community_college
shiga_university	shiga_university
sapporo_medical_university	sapporo_medical_university
midwest_university	midwest_university
asian_institute_of_management	asian_institute_of_management
college_of_technology_&_engineering,_udaipur	college_of_technology_&_engineering,_udaipur
bastyr_university	bastyr_university
jerusalem_college_of_technology	jerusalem_college_of_technology
lahore_school_of_economics	lahore_school_of_economics
mykolas_romeris_university	mykolas_romeris_university
tennessee_technological_university	tennessee_technological_university
mrk_university	mrk_university
northwest_mississippi_community_college	northwest_mississippi_community_college
kwangwoon_university	kwangwoon_university
university_of_colorado_colorado_springs	university_of_colorado
hankuk_university_of_foreign_studies	hankuk_university_of_foreign_studies
university_of_gedo	university_of_gedo
national_university_of_the_littoral	national_university_of_the_littoral
university_of_oulu	university_of_oulu
strathclyde_law_school	strathclyde_law_school
university_of_the_arctic	university_of_the_arctic
aditya_nath_jha_government_inter_college,_rudrapur	aditya_nath_jha_government_inter_college,_rudrapur
louvain_school_of_management	louvain_school_of_management
university_of_antioquia	university_of_antioquia
universidad_externado_de_colombia	universidad_externado_de_colombia
annamalai_university	annamalai_university
roger_williams_university	roger_williams_university
sri_jayachamarajendra_college_of_engineering	sri_jayachamarajendra_college_of_engineering
union_college	union_college
rmit_university	rmit_university
atharva_college_of_engineering_(ace),_malad	atharva_college_of_engineering_(ace),_malad
concordia_university	concordia_university
avila_university	avila_university
thiel_college	thiel_college
anna_maria_college	anna_maria_college
banaras_hindu_university	banaras_hindu_university
fu_jen_catholic_university	fu_jen_catholic_university
institute_for_christian_studies	institute_for_christian_studies
boston_state_college	boston_state_college
university_of_the_pacific_arthur_a._dugoni_school_of_dentistry	university_of_the_pacific_arthur_a._dugoni_school_of_dentistry
pacific_lutheran_university	pacific_lutheran_university
playa_ancha_university_of_educational_sciences	playa_ancha_university_of_educational_sciences
windesheim_university_of_applied_sciences	windesheim_university_of_applied_sciences
mercer_university	mercer_university
winthrop_university	winthrop_university
shatt_al-arab_university_college	shatt_al-arab_university_college
union_county_college	union_county_college
technical_university_of_crete	technical_university_of_crete
birralee_international_school_trondheim	birralee_international_school_trondheim
marlboro_college	marlboro_college
glenville_state_college	glenville_state_college
thadomal_shahani_engineering_college	thadomal_shahani_engineering_college
pamantasan_ng_lungsod_ng_pasig	pamantasan_ng_lungsod_ng_pasig
university_of_california,_berkeley_school_of_information	university_of_california,_berkeley_school_of_information
university_of_edinburgh_medical_school	university_of_edinburgh_medical_school
andrews_university	andrews_university
international_university_in_geneva	international_university_in_geneva
lebanon_valley_college	lebanon_valley_college
indian_institute_of_technology_gandhinagar	indian_institute_of_technology_gandhinagar
maastricht_university	maastricht_university
institute_of_technology,_blanchardstown	institute_of_technology,_blanchardstown
nizam_college	nizam_college
bilkent_faculty_of_business_administration	bilkent_faculty_of_business_administration
lawrence_university	lawrence_university
computer_university,_loikaw	computer_university,_loikaw
kumamoto_university	kumamoto_university
acadia_university	acadia_university
national_university_of_health_sciences	national_university_of_health_sciences
belarusian_state_university	belarusian_state_university
dr._ambedkar_institute_of_technology	dr._ambedkar_institute_of_technology
paris-sorbonne_university_abu_dhabi	paris-sorbonne_university_abu_dhabi
virginia_commonwealth_university	virginia_commonwealth_university
del_mar_college	del_mar_college
dr._b._r._ambedkar_university	dr._b._r._ambedkar_university
tamil_nadu_agricultural_university	tamil_nadu_agricultural_university
design_academy_eindhoven	design_academy_eindhoven
iqra_university	iqra_university
university_of_natal	university_of_natal
hutchinson_community_college	hutchinson_community_college
princeton_university	princeton_university
opole_university	opole_university
campuses_of_arellano_university	de_la_salle_araneta_university
campuses_of_arellano_university	trinity_university_of_asia
bryn_mawr_college	bryn_mawr_college
machakos_institute_of_technology	machakos_institute_of_technology
hampton_university	hampton_university
estonian_academy_of_arts	estonian_academy_of_arts
management_development_institute	management_development_institute
ganesh_shankar_vidyarthi_memorial_medical_college	ganesh_shankar_vidyarthi_memorial_medical_college
kazan_(volga_region)_federal_university	kazan_(volga_region)_federal_university
university_of_mannheim	university_of_mannheim
pakistan_air_force_academy	pakistan_air_force_academy
jorhat_engineering_college	jorhat_engineering_college
bilkent_university	bilkent_university
m_s_ramaiah_school_of_advanced_studies	m_s_ramaiah_school_of_advanced_studies
university_of_baltimore	university_of_baltimore
minnesota_state_university,_mankato	minnesota_state_university,_mankato
angelo_state_university	angelo_state_university
pontifical_athenaeum_regina_apostolorum	pontifical_athenaeum_regina_apostolorum
southern_adventist_university	southern_adventist_university
university_of_malaya	university_of_malaya
touro_university_college_of_medicine	touro_university_college_of_medicine
vitrina_university	vitrina_university
muw_alumnae_association	muw_alumnae_association
saint_michael's_college	saint_michael's_college
norwegian_defence_research_establishment	norwegian_defence_research_establishment
indian_military_academy	indian_military_academy
university_of_new_mexico	university_of_new_mexico
santa_monica_college	santa_monica_college
tallinn_university_of_technology	tallinn_university_of_technology
amherst_college	amherst_college
converse_college	converse_college
college_of_horticulture	college_of_horticulture
louisiana_tech_university	louisiana_tech_university
university_of_reims_champagne-ardenne	university_of_reims_champagne-ardenne
southern_university,_bangladesh	southern_university,_bangladesh
university_of_tennessee_at_martin	university_of_tennessee_at_martin
tel_aviv_university	tel_aviv_university
university_of_tasmania	university_of_tasmania
mbm_engineering_college	mbm_engineering_college
osaka_sangyo_university	osaka_sangyo_university
northwest_a&f_university	northwest_a&f_university
chiang_mai_university	chiang_mai_university
noakhali_government_college	noakhali_government_college
sambalpur_university	sambalpur_university
university_of_st_andrews	university_of_st_andrews
aichi_shinshiro_otani_university	aichi_shinshiro_otani_university
kakatiya_medical_college	kakatiya_medical_college
huntington_university_(united_states)	huntington_university_(united_states)
royal_institute_of_technology	royal_institute_of_technology
lillehammer_university_college	lillehammer_university_college
ochanomizu_university	ochanomizu_university
pabna_cadet_college	pabna_cadet_college
university_of_derby	university_of_derby
american_international_college	american_international_college
whitworth_university	whitworth_university
catholic_university_of_portugal	catholic_university_of_portugal
leeds_trinity_university	leeds_trinity_university
university_of_la_sabana	university_of_la_sabana
joseph_fourier_university	joseph_fourier_university
grand_valley_state_university	grand_valley_state_university
wako_university	wako_university
university_college_birmingham	university_college_birmingham
university_of_waterloo	oulton_college
university_of_waterloo	university_of_waterloo
university_of_waterloo	sauder_school_of_business
university_of_tartu_viljandi_culture_academy	university_of_tartu_viljandi_culture_academy
austin_peay_state_university	austin_peay_state_university
manchester_business_school	manchester_business_school
elizabethtown_college	elizabethtown_college
university_of_la_laguna	university_of_la_laguna
hebei_university	hebei_university
eastern_university,_sri_lanka	eastern_university,_sri_lanka
zhengzhou_university	zhengzhou_university
sir_j._j._college_of_architecture	sir_j._j._college_of_architecture
loyola_college,_chennai	loyola_college,_chennai
yeshiva_gedola_of_carteret	yeshiva_gedola_of_carteret
wichita_area_technical_college	wichita_area_technical_college
island_college_of_technology	island_college_of_technology
seoul_national_university_of_education	seoul_national_university_of_education
university_of_trento	university_of_trento
foundation_university	foundation_university
york_university	york_university
andhra_university	andhra_university
ural_state_university	ural_state_university
university_of_stuttgart	university_of_stuttgart
butler_community_college	butler_community_college
greenville_presbyterian_theological_seminary	greenville_presbyterian_theological_seminary
institute_of_science	institute_of_science
unsw_faculty_of_engineering	unsw_faculty_of_engineering
lane_community_college	lane_community_college
international_university_in_moscow	international_university_in_moscow
dayeh_university	dayeh_university
aalto_university	aalto_university
tokyo_university_of_foreign_studies	tokyo_university_of_foreign_studies
tokyo_university_of_foreign_studies	kindai_university
david_geffen_school_of_medicine_at_ucla	david_geffen_school_of_medicine_at_ucla
university_of_granada	university_of_granada
deen_dayal_upadhyaya_college	deen_dayal_upadhyaya_college
isle_of_wight_college	isle_of_wight_college
toronto_institute_of_pharmaceutical_technology	toronto_institute_of_pharmaceutical_technology
wesleyan_university_philippines	wesleyan_university_philippines
psg_college_of_technology	psg_college_of_technology
byu_school_of_accountancy	byu_school_of_accountancy
macmurray_college	macmurray_college
birmingham_city_business_school	birmingham_city_business_school
university_of_valencia	university_of_valencia
institute_for_creation_research	institute_for_creation_research
pontifical_catholic_university_of_argentina	pontifical_catholic_university_of_argentina
tehran_school_of_political_science	tehran_school_of_political_science
sylhet_agricultural_university	sylhet_agricultural_university
aichi_medical_university	aichi_medical_university
wu_yee_sun_college	wu_yee_sun_college
dedman_school_of_law	southern_methodist_university
chapman_university	chapman_university
bunker_hill_community_college	bunker_hill_community_college
fh_joanneum	fh_joanneum
sun_moon_university	sun_moon_university
east_carolina_university	east_carolina_university
punjabi_university	punjabi_university
valencia_catholic_university_saint_vincent_martyr	valencia_catholic_university_saint_vincent_martyr
massachusetts_institute_of_technology	massachusetts_institute_of_technology
dubai_pharmacy_college	dubai_pharmacy_college
reformed_presbyterian_theological_seminary	reformed_presbyterian_theological_seminary
darul_uloom_nadwatul_ulama	darul_uloom_nadwatul_ulama
gazi_university	gazi_university
university_of_bergen	university_of_bergen
mizoram_university	mizoram_university
university_of_sindh	university_of_sindh
elon_university	elon_university
university_of_ottawa	university_of_ottawa
regent_college	regent_college
baltimore_city_community_college	baltimore_city_community_college
university_of_human_environments	university_of_human_environments
presbyterian_theological_college	presbyterian_theological_college
roosevelt_college_quirino	roosevelt_college_quirino
hong_kong_institute_of_vocational_education	hong_kong_institute_of_vocational_education
royal_college_of_defence_studies	royal_college_of_defence_studies
eastern_mennonite_university	eastern_mennonite_university
pomona_college	pomona_college
franklin_pierce_university	franklin_pierce_university
international_christian_university	international_christian_university
lodz_university_of_technology	lodz_university_of_technology
sawai_mansingh_medical_college	sawai_mansingh_medical_college
university_of_the_llanos	university_of_the_llanos
institute_of_buddhist_studies	institute_of_buddhist_studies
georgetown_university_school_of_medicine	georgetown_university_school_of_medicine
morehouse_college	morehouse_college
trinity_university_(texas)	trinity_university_(texas)
national_sun_yat-sen_university	national_sun_yat-sen_university
university_campus_suffolk	university_campus_suffolk
university_campus_suffolk	university_of_cumbria
university_of_peshawar	university_of_peshawar
aston_university	aston_university
seth_anandram_jaipuria_college	seth_anandram_jaipuria_college
georgia_military_institute	georgia_military_institute
beaconhouse_national_university	beaconhouse_national_university
vanderbilt_university	vanderbilt_university
dakota_county_technical_college	dakota_county_technical_college
national_university_of_distance_education	national_university_of_distance_education
center_for_excellence_in_basic_sciences,_mumbai	center_for_excellence_in_basic_sciences,_mumbai
bharathiar_university	bharathiar_university
pepperdine_university	pepperdine_university
school_of_visual_arts	school_of_visual_arts
claremont_graduate_university	claremont_graduate_university
ateneo_de_manila_university	ateneo_de_manila_university
antwerp_management_school	antwerp_management_school
rwth_aachen_university	rwth_aachen_university
chubu_university	chubu_university
morgan_state_university	morgan_state_university
dibrugarh_university	dibrugarh_university
new_york_university	new_york_university
national_labor_college	national_labor_college
canadian_forces_college	canadian_forces_college
mcmaster_university	mcmaster_university
mcmaster_university	nscad_university
art_institute_of_pittsburgh	art_institute_of_pittsburgh
samundra_institute_of_maritime_studies	samundra_institute_of_maritime_studies
university_of_pennsylvania	university_of_pennsylvania
university_of_debrecen	university_of_debrecen
woodbury_university	woodbury_university
galveston_college	galveston_college
university_of_chicago	university_of_chicago
rcc_institute_of_information_technology	rcc_institute_of_information_technology
thunderbird_school_of_global_management	thunderbird_school_of_global_management
pakistan_institute_of_development_economics	pakistan_institute_of_development_economics
weber_state_university	weber_state_university
modul_university_vienna	modul_university_vienna
pontifical_university_of_salamanca	pontifical_university_of_salamanca
north_cross_school	north_cross_school
central_university_of_venezuela	central_university_of_venezuela
national_institute_of_technology,_patna	national_institute_of_technology,_patna
slavic_greek_latin_academy	slavic_greek_latin_academy
saint_anselm_college	saint_anselm_college
north_central_college	north_central_college
angelicum_college	angelicum_college
nagoya_university_of_foreign_studies	nagoya_university_of_foreign_studies
united_states_naval_academy	united_states_naval_academy
skyline_college	skyline_college
washington_university_in_st._louis	washington_university_in_st._louis
gauhati_university	gauhati_university
isolog_schools	isolog_schools
babcock_university	babcock_university
al-quds_open_university	al-quds_open_university
texas_a&m_international_university	texas_a&m_international_university
national_university_of_singapore	national_university_of_singapore
american_university_of_madaba	american_university_of_madaba
new_charter_university	new_charter_university
university_of_cebu	university_of_cebu
barry_university	barry_university
university_of_the_pacific_(united_states)	university_of_the_pacific_(united_states)
griffith_university	griffith_university
university_of_bradford	university_of_bradford
nihon_fukushi_university	nihon_fukushi_university
snead_state_community_college	snead_state_community_college
trinity_christian_college	trinity_christian_college
princess_of_naradhiwas_university	princess_of_naradhiwas_university
tadulako_university	tadulako_university
keshav_mahavidyalaya	keshav_mahavidyalaya
juniata_college	juniata_college
university_of_bahrain	university_of_bahrain
cardinal_stritch_university	cardinal_stritch_university
avans_university_of_applied_sciences	avans_university_of_applied_sciences
tuskegee_university	tuskegee_university
kiit_university	kiit_university
university_of_barcelona	university_of_barcelona
xi'an_jiaotong-liverpool_university	xi'an_jiaotong-liverpool_university
community_college_of_the_air_force	community_college_of_the_air_force
university_of_newcastle_(australia)	university_of_newcastle_(australia)
university_of_california,_san_diego	university_of_california,_san_diego
the_citadel,_the_military_college_of_south_carolina	the_citadel,_the_military_college_of_south_carolina
new_hampshire_outing_club	new_hampshire_outing_club
skidmore_college	skidmore_college
salt_lake_community_college	salt_lake_community_college
national_taipei_university_of_technology	national_taipei_university_of_technology
sungkyunkwan_university	sungkyunkwan_university
huntingdon_college	huntingdon_college
nelson_marlborough_institute_of_technology	nelson_marlborough_institute_of_technology
patrick_henry_college	patrick_henry_college
aashayein_foundation	aashayein_foundation
lamar_university	lamar_university
safdarjang_hospital	safdarjang_hospital
golden_gate_university	golden_gate_university
ness_wadia_college_of_commerce	christ_university
ness_wadia_college_of_commerce	ness_wadia_college_of_commerce
chaudhary_charan_singh_haryana_agricultural_university	chaudhary_charan_singh_haryana_agricultural_university
ziauddin_university	ziauddin_university
lee_woo_sing_college	lee_woo_sing_college
hiwassee_college	hiwassee_college
university_of_kufa	university_of_kufa
epic_bible_college	epic_bible_college
mount_meru_university	mount_meru_university
bethany_lutheran_college	bethany_lutheran_college
university_of_cumbria	university_of_cumbria
algonquin_college	algonquin_college
dow_medical_college	dow_medical_college
georgian_court_university	georgian_court_university
dickinson_college	dickinson_college
national_college_of_ireland	national_college_of_ireland
krida_wacana_christian_university	krida_wacana_christian_university
texas_a&m_university	texas_a&m_university
nagoya_sangyo_university	nagoya_sangyo_university
dawson_college	dawson_college
sri_palee_college	sri_palee_college
plekhanov_russian_university_of_economics	plekhanov_russian_university_of_economics
osaka_medical_college	osaka_medical_college
heidelberg_university	heidelberg_university
university_of_international_relations	university_of_international_relations
ryerson_university	ryerson_university
transylvania_university	transylvania_university
university_of_saskatchewan_college_of_law	university_of_saskatchewan_college_of_law
silliman_university	silliman_university
hannover_medical_school	hannover_medical_school
university_of_california,_berkeley	holy_names_university
university_of_california,_berkeley	university_of_california,_berkeley
university_of_california,_berkeley	university_of_california
vidyajyoti_college_of_theology	vidyajyoti_college_of_theology
syracuse_university	syracuse_university
jan_kochanowski_university	jan_kochanowski_university
georgia_state_university	georgia_state_university
bangalore_university	bangalore_university
yeshiva_university	yeshiva_university
nihon_university	nihon_university
jambi_university	jambi_university
university_of_dar_es_salaam	university_of_dar_es_salaam
university_of_agder	university_of_agder
trevecca_nazarene_university	trevecca_nazarene_university
rochester_institute_of_technology_-_dubai	rochester_institute_of_technology_-_dubai
brescia_university_college	brescia_university_college
san_juan_de_dios_educational_foundation	san_juan_de_dios_educational_foundation
katholieke_universiteit_leuven_kulak	katholieke_universiteit_leuven_kulak
university_of_otago	university_of_otago
trent_university	trent_university
southern_cross_catholic_college	southern_cross_catholic_college
southeast_missouri_state_university	southeast_missouri_state_university
surendranath_college	surendranath_college
university_of_wollongong_faculty_of_engineering	university_of_wollongong
lynn_university	lynn_university
longwood_university	longwood_university
maine_college_of_art	maine_college_of_art
prince_sultan_university	prince_sultan_university
ie_business_school	ie_business_school
southern_wesleyan_university	southern_wesleyan_university
allama_iqbal_medical_college	allama_iqbal_medical_college
mansfield_university_of_pennsylvania	mansfield_university_of_pennsylvania
nagoya_gakuin_university	nagoya_gakuin_university
university_of_portland	university_of_portland
upper_iowa_university	upper_iowa_university
catawba_valley_community_college	catawba_valley_community_college
indian_institute_of_technology_madras	indian_institute_of_technology_madras
jadavpur_university	jadavpur_university
bells_university_of_technology	bells_university_of_technology
franklin_&_marshall_college	franklin_&_marshall_college
university_of_washington_north_sound	university_of_washington
university_of_washington_north_sound	university_of_washington_north_sound
university_of_washington_north_sound	university_of_washington_tacoma
shimer_college	shimer_college
st._augustine_university_of_tanzania	st._augustine_university_of_tanzania
sylhet_international_university	sylhet_international_university
fisk_university	fisk_university
grambling_state_university	grambling_state_university
university_of_westminster	university_of_westminster
troy_university_at_montgomery	troy_university_at_montgomery
tennessee_state_university	tennessee_state_university
bowdoin_college	bowdoin_college
southern_virginia_university	southern_virginia_university
industrial_design_centre	industrial_design_centre
our_lady_of_the_lake_university	our_lady_of_the_lake_university
palmer_college_of_chiropractic	palmer_college_of_chiropractic
auckland_university_of_technology	auckland_university_of_technology
tamagawa_university	tamagawa_university
american_sentinel_university	american_sentinel_university
thompson_rivers_university,_open_learning	thompson_rivers_university,_open_learning
st._albert's_college	jawaharlal_nehru_technological_university,_kakinada
st._albert's_college	st._albert's_college
monash_college	monash_college
oakland_community_college	oakland_community_college
azerbaijan_state_marine_academy	azerbaijan_state_marine_academy
charlotte_swenson_memorial_bible_training_school	charlotte_swenson_memorial_bible_training_school
maine_maritime_academy	maine_maritime_academy
georgia_tech_lorraine	georgia_tech_lorraine
american_university	american_university
oxford_college_of_emory_university	emory_university
oxford_college_of_emory_university	oxford_college_of_emory_university
oxford_college_of_emory_university	emory_university_school_of_law
laval_university	laval_university
bhoj_reddy_engineering_college_for_women	bhoj_reddy_engineering_college_for_women
visvesvaraya_technological_university	visvesvaraya_technological_university
central_saint_martins	central_saint_martins
monmouth_college	monmouth_college
elgin_community_college	elgin_community_college
shanghai_finance_university	shanghai_finance_university
indian_institute_of_foreign_trade	indian_institute_of_foreign_trade
lyndon_state_college	lyndon_state_college
penang_medical_college	penang_medical_college
goa_university	goa_university
indian_institute_of_management_ahmedabad	indian_institute_of_management_ahmedabad
swansea_university	swansea_university
lalit_narayan_mithila_university	lalit_narayan_mithila_university
melbourne_business_school	melbourne_business_school
odessa_national_maritime_academy	odessa_national_maritime_academy
pakistan_military_academy	pakistan_military_academy
university_of_the_western_cape	university_of_the_western_cape
capilano_university	capilano_university
link_campus_university	link_campus_university
shuchiin_university	shuchiin_university
camosun_college	camosun_college
st._augustine's_seminary	st._augustine's_seminary
university_of_stirling	university_of_stirling
godfrey_okoye_university	godfrey_okoye_university
university_of_calcutta	university_of_calcutta
university_of_northampton	university_of_northampton
hamilton_technical_college	hamilton_technical_college
philadelphia_college_of_osteopathic_medicine	philadelphia_college_of_osteopathic_medicine
rutgers_university	rutgers_university
rutgers_university	new_jersey_medical_school
national_college_of_arts	national_college_of_arts
usc_marshall_school_of_business	usc_marshall_school_of_business
gifu_university_of_medical_science	gifu_university_of_medical_science
king_saud_university	king_saud_university
university_of_pamplona	university_of_pamplona
menlo_college	menlo_college
florida_polytechnic_university	florida_polytechnic_university
colvin_taluqdars'_college	colvin_taluqdars'_college
karadeniz_technical_university	karadeniz_technical_university
raman_research_institute	raman_research_institute
national_institute_of_design	national_institute_of_design
university_of_illinois_at_chicago	university_of_illinois_at_chicago
myanmar_institute_of_theology	myanmar_institute_of_theology
alcorn_state_university	alcorn_state_university
christianeum_hamburg	christianeum_hamburg
american_university_of_sharjah	american_university_of_sharjah
al-hussein_bin_talal_university	al-hussein_bin_talal_university
tampere_university_of_technology	tampere_university_of_technology
central_philippine_university	central_philippine_university
asia-pacific_international_university	asia-pacific_international_university
panamerican_university	panamerican_university
somali_national_university	somali_national_university
letterkenny_institute_of_technology	letterkenny_institute_of_technology
america_bangladesh_university	america_bangladesh_university
cox_school_of_business	cox_school_of_business
el_shorouk_academy	el_shorouk_academy
dijlah_university_college	dijlah_university_college
university_of_caldas	university_of_caldas
toyohashi_sozo_college	toyohashi_sozo_college
college_of_europe	college_of_europe
university_of_tampa	university_of_tampa
pontifical_gregorian_university	pontifical_gregorian_university
university_of_lethbridge	university_of_lethbridge
massachusetts_college_of_liberal_arts	massachusetts_college_of_liberal_arts
university_of_louisiana_at_monroe	university_of_louisiana_at_monroe
memphis_college_of_art	memphis_college_of_art
international_institute_of_social_studies	international_institute_of_social_studies
helsinki_university_of_technology	helsinki_university_of_technology
australian_national_university	australian_national_university
charter_oak_state_college	charter_oak_state_college
saint_vincent_college	saint_vincent_college
university_college_of_the_north	university_college_of_the_north
curtin_university	curtin_university
university_of_valladolid	university_of_valladolid
lithuanian_university_of_health_sciences	lithuanian_university_of_health_sciences
pompeu_fabra_university	pompeu_fabra_university
heald_college	heald_college
northeastern_university	northeastern_university
university_of_novi_sad	university_of_novi_sad
marymount_university	marymount_university
lucian_blaga_university_of_sibiu	lucian_blaga_university_of_sibiu
hakuoh_university	hakuoh_university
toyo_university	toyo_university
beal_college	beal_college
kalamazoo_college	kalamazoo_college
odessa_college	odessa_college
military_academy_of_the_general_staff_of_the_armed_forces_of_russia	military_academy_of_the_general_staff_of_the_armed_forces_of_russia
estonian_aviation_academy	estonian_aviation_academy
central_university_of_himachal_pradesh	central_university_of_himachal_pradesh
institute_for_advanced_study	institute_for_advanced_study
vu_university_amsterdam	vu_university_amsterdam
al-muthana_university	al-muthana_university
taylor's_university	taylor's_university
rice_university	rice_university
university_of_colorado_boulder	university_of_colorado_boulder
coker_college	coker_college
chalmers_university_of_technology	chalmers_university_of_technology
millsaps_college	millsaps_college
bicol_university_tabaco_campus	bicol_university_tabaco_campus
university_of_san_diego	university_of_san_diego
lala_lajpat_rai_memorial_medical_college	lala_lajpat_rai_memorial_medical_college
university_of_california	university_of_california
california_university_of_pennsylvania	california_university_of_pennsylvania
villanova_university	villanova_university
national_university_of_colombia	national_university_of_colombia
charles_university_in_prague	charles_university_in_prague
khalsa_college,_amritsar	khalsa_college,_amritsar
red_deer_college	red_deer_college
malla_reddy_engineering_college	malla_reddy_engineering_college
university_for_foreigners_perugia	university_for_foreigners_perugia
hollins_university	hollins_university
favaloro_university	favaloro_university
bongaigaon_college	bongaigaon_college
framingham_state_university	framingham_state_university
hogeschool_van_amsterdam	hogeschool_van_amsterdam
granite_state_college	granite_state_college
scripps_college	scripps_college
puntland_state_university	puntland_state_university
polytechnic_university_of_tirana	polytechnic_university_of_tirana
johnson_&_wales_university	johnson_&_wales_university
sibelius_academy	sibelius_academy
university_of_geneva	university_of_geneva
national_war_college	national_war_college
olivet_university	olivet_university
reed_college	reed_college
drake_university	drake_university
university_of_buckingham	university_of_buckingham
troy_university	troy_university
university_of_peloponnese	university_of_peloponnese
university_of_johannesburg	university_of_johannesburg
college_of_the_ozarks	college_of_the_ozarks
university_of_texas_at_san_antonio	university_of_texas_at_san_antonio
university_of_texas_at_san_antonio	university_of_texas_at_dallas
university_of_texas_at_san_antonio	university_of_texas_at_austin
trinity_valley_school	trinity_valley_school
dartmouth_college	dartmouth_college
islamic_university_college,_ghana	islamic_university_college,_ghana
government_law_college,_coimbatore	government_law_college,_coimbatore
champlain_college	champlain_college
iwate_university	iwate_university
arlington_baptist_college	arlington_baptist_college
baker_university	baker_university
meio_university	meio_university
fresno_city_college	fresno_city_college
diplomatic_academy_of_vienna	diplomatic_academy_of_vienna
guangxi_medical_university	guangxi_medical_university
university_of_pittsburgh_school_of_pharmacy	university_of_pittsburgh_school_of_pharmacy
china_conservatory_of_music	china_conservatory_of_music
indian_council_of_agricultural_research	indian_council_of_agricultural_research
meijo_university	meijo_university
ite_college_west	ite_college_west
james_madison_university	james_madison_university
university_of_flensburg	university_of_flensburg
chung_chi_college	chung_chi_college
mid-continent_university	mid-continent_university
sholokhov_moscow_state_university_for_humanities	sholokhov_moscow_state_university_for_humanities
seton_hall_university_school_of_law	seton_hall_university_school_of_law
clemson_university	clemson_university
sonoma_state_university	sonoma_state_university
edward_waters_college	edward_waters_college
national_chengchi_university	national_chengchi_university
san_diego_city_college	san_diego_city_college
tianjin_medical_university	tianjin_medical_university
shaheed_udham_singh_college_of_engineering_&_technology	shaheed_udham_singh_college_of_engineering_&_technology
virginia_union_university	virginia_union_university
assumption_university_(thailand)	assumption_university_(thailand)
university_of_southern_california	university_of_southern_california
academy_of_art_university	academy_of_art_university
san_pedro_college	san_pedro_college
quaid-i-azam_university	quaid-i-azam_university
birmingham_school_of_acting	birmingham_school_of_acting
maryville_college	maryville_college
university_of_central_florida	university_of_central_florida
john_f._kennedy_university	john_f._kennedy_university
xavier_institute_of_social_service	xavier_institute_of_social_service
university_of_california,_los_angeles	university_of_california,_los_angeles
central_colleges_of_the_philippines	central_colleges_of_the_philippines
temasek_polytechnic	temasek_polytechnic
northern_school_of_contemporary_dance	northern_school_of_contemporary_dance
the_new_school	the_new_school
ostwestfalen-lippe_university_of_applied_sciences	ostwestfalen-lippe_university_of_applied_sciences
australian_national_academy_of_music	australian_national_academy_of_music
leeds_college_of_music	leeds_college_of_music
bucerius_law_school	bucerius_law_school
betty_irene_moore_school_of_nursing	betty_irene_moore_school_of_nursing
dean_college	dean_college
australian_graduate_school_of_management	australian_graduate_school_of_management
university_of_southern_philippines_foundation	university_of_southern_philippines_foundation
saratov_state_university	saratov_state_university
full_sail_university	full_sail_university
augsburg_college	augsburg_college
unification_theological_seminary	unification_theological_seminary
copenhagen_business_school	copenhagen_business_school
iese_business_school	iese_business_school
king_george's_medical_university	king_george's_medical_university
american_repertory_company	american_repertory_company
depauw_university	depauw_university
university_of_central_punjab	university_of_central_punjab
azerbaijan_university	azerbaijan_university
edgewood_college	edgewood_college
ramakrishna_mission_vivekananda_college	ramakrishna_mission_vivekananda_college
thammasat_university	ramkhamhaeng_university
thammasat_university	thammasat_university
cleveland_community_college	cleveland_community_college
waterford_institute_of_technology	waterford_institute_of_technology
zhukovsky_air_force_engineering_academy	zhukovsky_air_force_engineering_academy
institute_of_space_technology	institute_of_space_technology
university_of_ghana	university_of_ghana
european_university_of_madrid	european_university_of_madrid
rasmussen_college	rasmussen_college
washington_state_university	washington_state_university
hogeschool_gent	hogeschool_gent
century_college	century_college
university_of_bern	university_of_bern
university_of_applied_sciences_wedel	university_of_applied_sciences_wedel
telecom_sudparis	telecom_sudparis
adekunle_ajasin_university	adekunle_ajasin_university
dhaka_commerce_college	dhaka_commerce_college
graduate_school_of_chinese_academy_of_social_sciences	graduate_school_of_chinese_academy_of_social_sciences
university_of_st._thomas_(texas)	university_of_st._thomas_(texas)
florida_gulf_coast_university	florida_gulf_coast_university
central_party_school_of_the_communist_party_of_china	central_party_school_of_the_communist_party_of_china
rotman_school_of_management	rotman_school_of_management
university_of_georgia_college_of_pharmacy	university_of_georgia_college_of_pharmacy
candler_school_of_theology	candler_school_of_theology
radford_university	radford_university
king_saud_bin_abdulaziz_university_for_health_sciences	king_saud_bin_abdulaziz_university_for_health_sciences
kabul_university	kabul_university
university_of_hartford	university_of_hartford
nagoya_college	nagoya_college
madenat_alelem_university_college	madenat_alelem_university_college
north_central_university	north_central_university
columbia_university_school_of_general_studies	columbia_university_school_of_general_studies
marin_barleti_university	marin_barleti_university
tezpur_university	tezpur_university
university_of_glasgow	university_of_glasgow
arnhem_business_school	arnhem_business_school
university_of_diyala	university_of_diyala
baqai_medical_university	baqai_medical_university
stephens_college	stephens_college
aichi_gakusen_university	aichi_gakusen_university
snow_college	snow_college
international_space_university	international_space_university
hacettepe_university	hacettepe_university
russian_state_university_for_the_humanities	russian_state_university_for_the_humanities
erasmus_university_rotterdam	erasmus_university_rotterdam
arizona_state_university_at_the_downtown_phoenix_campus	arizona_state_university_at_the_downtown_phoenix_campus
colby_community_college	colby_community_college
texas_lutheran_university	texas_lutheran_university
trinity_college,_toronto	trinity_college,_toronto
marquette_university	marquette_university
university_of_michigan	university_of_michigan
evangel_university	evangel_university
indian_national_science_academy	indian_national_science_academy
national_defence_university,_pakistan	national_defence_university,_pakistan
indian_institute_of_management_indore	indian_institute_of_management_indore
sunraysia_institute_of_tafe	sunraysia_institute_of_tafe
hochschule_furtwangen_university	hochschule_furtwangen_university
karlsruhe_institute_of_technology	karlsruhe_institute_of_technology
radboud_university_nijmegen	radboud_university_nijmegen
los_angeles_mission_college	los_angeles_mission_college
rajasthan_technical_university	rajasthan_technical_university
krishna_kanta_handiqui_state_open_university	krishna_kanta_handiqui_state_open_university
whitman_college	whitman_college
alliance_university	alliance_university
howard_university	howard_university
hamburg_university_of_applied_sciences	hamburg_university_of_applied_sciences
university_of_denver	university_of_denver
st._edward's_university	st._edward's_university
qingdao_technological_university	qingdao_technological_university
university_of_chester	university_of_chester
gustavus_adolphus_college	gustavus_adolphus_college
mccombs_school_of_business	mccombs_school_of_business
regis_college,_toronto	regis_college,_toronto
hubert_kairuki_memorial_university	hubert_kairuki_memorial_university
willy_brandt_school_of_public_policy	willy_brandt_school_of_public_policy
cass_business_school	cass_business_school
heilbronn_university	heilbronn_university
tokyo_university_of_science	tokyo_university_of_science
university_of_ibadan	university_of_ibadan
general_theological_seminary	general_theological_seminary
ramon_llull_university	ramon_llull_university
communication_university_of_china	communication_university_of_china
valdosta_state_university	valdosta_state_university
drew_university	drew_university
national_technological_university	national_technological_university
california_state_university,_chico	california_state_university,_chico
queen_mary_university_of_london	queen_mary_university_of_london
washington_&_jefferson_college	washington_&_jefferson_college
university_of_trier	university_of_trier
technological_institute_of_the_philippines	technological_institute_of_the_philippines
gifu_university	gifu_university
university_of_balochistan	university_of_balochistan
institute_of_rural_management_anand	institute_of_rural_management_anand
fatima_jinnah_dental_college	fatima_jinnah_dental_college
nagoya_women's_university	nagoya_women's_university
princeton_theological_seminary	princeton_theological_seminary
american_university_in_dubai	american_university_in_dubai
columbia_state_community_college	columbia_state_community_college
southern_illinois_university	southern_illinois_university
vaal_university_of_technology	vaal_university_of_technology
cleary_university	cleary_university
royal_agricultural_university	royal_agricultural_university
university_of_oviedo	university_of_oviedo
wayamba_university_of_sri_lanka	wayamba_university_of_sri_lanka
all_nations_university	all_nations_university
criswell_college	criswell_college
new_jersey_city_university	mercer_county_community_college
new_jersey_city_university	new_jersey_city_university
nippon_bunri_university	nippon_bunri_university
loras_college	loras_college
sanjay_gandhi_post_graduate_institute_of_medical_sciences	sanjay_gandhi_post_graduate_institute_of_medical_sciences
jawaharlal_nehru_technological_university,_anantapur	jawaharlal_nehru_technological_university,_anantapur
southwest_university	southwest_university
albright_college	albright_college
coleg_menai	coleg_menai
averett_university	averett_university
reims_management_school	reims_management_school
birmingham_conservatoire	birmingham_conservatoire
state_university_of_zanzibar	state_university_of_zanzibar
university_of_kirkuk	university_of_kirkuk
konkuk_university	konkuk_university
drexel_university_sacramento	drexel_university_sacramento
cosumnes_river_college	cosumnes_river_college
shigakkan_university	shigakkan_university
national_university_of_cuyo	national_university_of_cuyo
san_jacinto_college	san_jacinto_college
paris_13_university	paris_13_university
faculty_of_management_studies	faculty_of_management_studies
lal_bahadur_shastri_national_academy_of_administration	lal_bahadur_shastri_national_academy_of_administration
university_of_al-qadisiyah	university_of_al-qadisiyah
avondale_college	avondale_college
university_of_birmingham	university_of_birmingham
royal_college_of_art	royal_college_of_art
lovely_professional_university	lovely_professional_university
usman_institute_of_technology	usman_institute_of_technology
starr_king_school_for_the_ministry	starr_king_school_for_the_ministry
orissa_engineering_college	orissa_engineering_college
university_canada_west	university_canada_west
otago_polytechnic	otago_polytechnic
donetsk_state_university_of_management	donetsk_state_university_of_management
national_tennis_club	national_tennis_club
occidental_college	occidental_college
singapore_polytechnic	singapore_polytechnic
saint_mary's_college_of_california	saint_mary's_college_of_california
al-hadba'a_university_college	al-hadba'a_university_college
hubbard_college_of_administration_international	hubbard_college_of_administration_international
columbia_university	columbia_university
parsons_the_new_school_for_design	parsons_the_new_school_for_design
istituto_marangoni	istituto_marangoni
nangarhar_university	nangarhar_university
athlone_institute_of_technology	athlone_institute_of_technology
university_of_sucre	university_of_sucre
california_state_university,_fresno	california_state_university,_fresno
bauman_moscow_state_technical_university	bauman_moscow_state_technical_university
university_of_applied_sciences_kufstein	university_of_applied_sciences_kufstein
globalnxt_university	globalnxt_university
university_of_buenos_aires	university_of_buenos_aires
jabalpur_engineering_college	jabalpur_engineering_college
college_of_the_holy_cross	college_of_the_holy_cross
sapienza_university_of_rome	sapienza_university_of_rome
worcester_state_university	worcester_state_university
electronic_engineering_polytechnic_institute_of_surabaya	electronic_engineering_polytechnic_institute_of_surabaya
ningxia_university	ningxia_university
asutosh_college	asutosh_college
biola_university	biola_university
bradford_college_(united_states)	bradford_college_(united_states)
st._michael's_college,_toronto	st._michael's_college,_toronto
toyama_national_college_of_maritime_technology	toyama_national_college_of_maritime_technology
kilgore_college	kilgore_college
university_of_rhode_island	university_of_rhode_island
cebu_doctors'_university	cebu_doctors'_university
toyota_national_college_of_technology	toyota_national_college_of_technology
austin_community_college_district	austin_community_college_district
simon_fraser_university	simon_fraser_university
university_college_maastricht	university_college_maastricht
eckerd_college	eckerd_college
center_for_cartoon_studies	center_for_cartoon_studies
university_of_karachi	university_of_karachi
takoradi_polytechnic	takoradi_polytechnic
sabaragamuwa_university_of_sri_lanka	sabaragamuwa_university_of_sri_lanka
bharati_vidyapeeth's_college_of_engineering	bharati_vidyapeeth's_college_of_engineering
university_of_california,_riverside	university_of_california,_riverside
finlandia_university	finlandia_university
furman_university	furman_university
furman_university	newberry_college
kumaun_university	kumaun_university
chuvash_state_university	chuvash_state_university
bucknell_university	bucknell_university
the_kubert_school	the_kubert_school
bishop's_university	bishop's_university
nettur_technical_training_foundation	nettur_technical_training_foundation
national_taiwan_normal_university	national_taiwan_normal_university
cheyney_university_of_pennsylvania	cheyney_university_of_pennsylvania
university_of_shanghai	university_of_shanghai
manipal_institute_of_technology	manipal_institute_of_technology
shri_ramachandra_bhanj_medical_college	shri_ramachandra_bhanj_medical_college
maharishi_university_of_management	maharishi_university_of_management
murdoch_university	murdoch_university
kyoto_sangyo_university	kyoto_sangyo_university
comsats_institute_of_information_technology	comsats_institute_of_information_technology
aristotle_university_of_thessaloniki	aristotle_university_of_thessaloniki
college_of_magic	college_of_magic
kwansei_gakuin_university	kwansei_gakuin_university
tata_institute_of_social_sciences	tata_institute_of_social_sciences
niigata_university	niigata_university
rajiv_gandhi_university	rajiv_gandhi_university
royal_roads_military_college	royal_roads_military_college
fordham_university	fordham_university
al-baath_university	al-baath_university
aichi_prefectural_university	aichi_prefectural_university
university_of_north_texas_at_dallas	university_of_north_texas_at_dallas
centre_college	centre_college
central_conservatory_of_music	central_conservatory_of_music
scott_community_college	scott_community_college
gwynedd_mercy_university	gwynedd_mercy_university
university_of_helsinki	university_of_helsinki
university_of_east_anglia	university_of_east_anglia
mcnally_smith_college_of_music	mcnally_smith_college_of_music
aichi_mizuho_college	aichi_mizuho_college
eastern_kentucky_university	eastern_kentucky_university
iae_lyon	iae_lyon
college_for_creative_studies	college_for_creative_studies
columbia_college_chicago	columbia_college_chicago
carleton_college	carleton_college
luther_college_(iowa)	luther_college_(iowa)
marion_military_institute	marion_military_institute
saint_joseph's_college_of_maine	saint_joseph's_college_of_maine
university_of_isfahan	university_of_isfahan
astrakhan_state_technical_university	astrakhan_state_technical_university
university_of_indonesia	university_of_indonesia
idbm	idbm
warsaw_school_of_economics	warsaw_school_of_economics
erskine_college	erskine_college
weill_cornell_medical_college	weill_cornell_medical_college
beirut_arab_university	beirut_arab_university
university_of_georgia_college_of_public_health	university_of_georgia_college_of_public_health
springfield_college_(massachusetts)	springfield_college_(massachusetts)
yonsei_university	yonsei_university
colorado_school_of_mines	colorado_school_of_mines
saint_mary's_university_of_minnesota	saint_mary's_university_of_minnesota
international_college_of_management,_sydney	international_college_of_management,_sydney
university_of_north_alabama	university_of_north_alabama
jefferson_college_(missouri)	jefferson_college_(missouri)
dallas_baptist_university	dallas_baptist_university
national_defense_university	national_defense_university
lewis_&_clark_college	lewis_&_clark_college
liaoning_university	liaoning_university
bangabandhu_sheikh_mujib_medical_university	bangabandhu_sheikh_mujib_medical_university
national_law_school_of_india_university	national_law_school_of_india_university
university_of_texas_at_el_paso	university_of_texas_at_el_paso
the_college_of_new_jersey	the_college_of_new_jersey
anhui_agricultural_university	anhui_agricultural_university
chicago_state_university	chicago_state_university
conrad_grebel_university_college	conrad_grebel_university_college
college_of_southern_maryland	college_of_southern_maryland
services_institute_of_medical_sciences	services_institute_of_medical_sciences
manila_central_university	manila_central_university
university_of_lagos	university_of_lagos
millersville_university_of_pennsylvania	millersville_university_of_pennsylvania
university_of_alberta	university_of_alberta
western_seminary	western_seminary
admiral_makarov_national_university_of_shipbuilding	admiral_makarov_national_university_of_shipbuilding
pratt_institute	pratt_institute
seoul_national_university	seoul_national_university
beijing_jiaotong_university	beijing_jiaotong_university
belhaven_university	belhaven_university
university_of_divinity	university_of_divinity
cefam	cefam
south_eastern_university_of_sri_lanka	south_eastern_university_of_sri_lanka
european_graduate_school	european_graduate_school
zhejiang_university	zhejiang_university
phoenix_seminary	phoenix_seminary
university_of_valle	university_of_valle
lehigh_carbon_community_college	lehigh_carbon_community_college
anaheim_university	anaheim_university
aichi_sangyo_university	aichi_sangyo_university
open_university_of_catalonia	open_university_of_catalonia
american_intercontinental_university	american_intercontinental_university
andhra_university_college_of_engineering	andhra_university_college_of_engineering
istanbul_technical_university	istanbul_technical_university
university_of_the_cordilleras	university_of_the_cordilleras
baku_state_university	baku_state_university
tennessee_college_of_applied_technology_-_shelbyville	tennessee_college_of_applied_technology_-_shelbyville
toyohashi_university_of_technology	toyohashi_university_of_technology
acharya_narendra_dev_college	acharya_narendra_dev_college
ohkagakuen_university	ohkagakuen_university
pacific_union_college	pacific_union_college
afeka_college_of_engineering	afeka_college_of_engineering
fairleigh_dickinson_university	fairleigh_dickinson_university
university_of_pannonia	university_of_pannonia
pachaiyappa's_college	pachaiyappa's_college
bangalore_institute_of_technology	bangalore_institute_of_technology
university_of_the_district_of_columbia	university_of_the_district_of_columbia
medical_university_of_vienna	medical_university_of_vienna
art_center_college_of_design	art_center_college_of_design
essec_business_school	essec_business_school
istanbul_bilgi_university	istanbul_bilgi_university
university_of_texas_at_dallas	university_of_texas_at_dallas
virginia_state_university	virginia_state_university
widener_university	widener_university
sciences_po_aix	sciences_po_aix
rowan_university	rowan_university
university_of_cagliari	university_of_cagliari
university_of_dublin	university_of_dublin
copenhagen_institute_of_interaction_design	copenhagen_institute_of_interaction_design
indian_institute_of_technology_guwahati	indian_institute_of_technology_guwahati
church_divinity_school_of_the_pacific	church_divinity_school_of_the_pacific
japanese_red_cross_toyota_college_of_nursing	japanese_red_cross_toyota_college_of_nursing
blekinge_institute_of_technology	blekinge_institute_of_technology
banha_university	banha_university
philippine_christian_university	philippine_christian_university
southwest_tennessee_community_college	southwest_tennessee_community_college
john_a._gupton_college	john_a._gupton_college
aichi_toho_university	aichi_toho_university
university_of_la_guajira	university_of_la_guajira
albert_einstein_college_of_medicine	albert_einstein_college_of_medicine
biju_patnaik_university_of_technology	biju_patnaik_university_of_technology
badruka_college	badruka_college
brigham_young_university	brigham_young_university
punjab_university_college_of_information_technology	punjab_university_college_of_information_technology
palomar_college	palomar_college
fujita_health_university	fujita_health_university
leeds_thomas_danby	leeds_thomas_danby
royal_military_college_of_canada	royal_military_college_of_canada
saint_petersburg_state_medical_academy	saint_petersburg_state_medical_academy
unsw_residential_communities,_university_of_new_south_wales	university_of_new_south_wales
ramapo_college	ramapo_college
far_eastern_federal_university	far_eastern_federal_university
sauder_school_of_business	sauder_school_of_business
tai_poutini_polytechnic	tai_poutini_polytechnic
sakarya_university	sakarya_university
plymouth_state_university	plymouth_state_university
beijing_international_studies_university	beijing_international_studies_university
johns_hopkins_school_of_medicine	johns_hopkins_university
taipei_medical_university	taipei_medical_university
dongguk_university	dongguk_university
european_humanities_university	european_humanities_university
maranatha_christian_university	maranatha_christian_university
peoples'_friendship_university_of_russia	peoples'_friendship_university_of_russia
university_of_cambridge	university_of_cambridge
glion_institute_of_higher_education	glion_institute_of_higher_education
kunming_medical_university	kunming_medical_university
rissho_university	rissho_university
psg_institute_of_management_coimbatore	psg_institute_of_management_coimbatore
tunghai_university	tunghai_university
community_college_of_philadelphia	community_college_of_philadelphia
university_of_north_carolina_at_pembroke	university_of_north_carolina_at_pembroke
hanken_school_of_economics	hanken_school_of_economics
meharry_medical_college	meharry_medical_college
centro_universitario_anglo_mexicano	centro_universitario_anglo_mexicano
university_of_the_immaculate_conception	university_of_the_immaculate_conception
beth_medrash_govoha	beth_medrash_govoha
edge_hill_university	edge_hill_university
university_of_the_west_of_england	university_of_the_west_of_england
middle_east_technical_university	middle_east_technical_university
spring_hill_college	spring_hill_college
stevens_institute_of_technology	stevens_institute_of_technology
ehime_university	ehime_university
wycliffe_college,_toronto	wycliffe_college,_toronto
azerbaijan_international_university	azerbaijan_international_university
old_dominion_university	old_dominion_university
tianjin_university_of_commerce	tianjin_university_of_commerce
istanbul_commerce_university	istanbul_commerce_university
la_sierra_university	la_sierra_university
arab_open_university	arab_open_university
spelman_college	spelman_college
kean_university	kean_university
sogang_university	sogang_university
university_of_new_brunswick	university_of_new_brunswick
towson_university	towson_university
augusta_state_university	augusta_state_university
university_of_kansas_edwards_campus	university_of_kansas
texas_tech_university	texas_tech_university
university_of_western_ontario	university_of_western_ontario
baltimore_hebrew_university	baltimore_hebrew_university
daytona_state_college	daytona_state_college
seward_county_community_college	seward_county_community_college
adelphi_university	adelphi_university
york_technical_college	york_technical_college
les_roches_jin_jiang_international_hotel_management_college	les_roches_jin_jiang_international_hotel_management_college
utah_state_university	utah_state_university
omdurman_ahlia_university	omdurman_ahlia_university
helderberg_college	helderberg_college
kafrelsheikh_university	kafrelsheikh_university
kaplan_university	kaplan_university
georgetown_college	georgetown_college
thi_qar_university	thi_qar_university
helwan_university	helwan_university
annenberg_school_for_communication_at_the_university_of_pennsylvania	annenberg_school_for_communication_at_the_university_of_pennsylvania
international_islamic_university_malaysia	international_islamic_university_malaysia
waldorf_college	waldorf_college
university_of_notre_dame	university_of_notre_dame
the_principia	the_principia
universidad_nueva_esparta	universidad_nueva_esparta
portland_community_college	portland_community_college
university_of_greifswald	university_of_greifswald
assiut_university	assiut_university
heythrop_college,_university_of_london	heythrop_college,_university_of_london
south_mountain_community_college	south_mountain_community_college
greenville_technical_college	greenville_technical_college
university_of_burgos	university_of_burgos
royal_welsh_college_of_music_&_drama	royal_welsh_college_of_music_&_drama
colby_college	colby_college
university_of_idaho	university_of_idaho
brandeis_university	brandeis_university
ravenshaw_college	ravenshaw_college
st._charles_community_college	st._charles_community_college
university_of_sussex	university_of_sussex
georgia_tech_alumni_association	georgia_tech_alumni_association
nippon_sport_science_university	nippon_sport_science_university
stockholm_school_of_entrepreneurship	stockholm_school_of_entrepreneurship
jacksonville_university	jacksonville_university
toyota_technological_institute	toyota_technological_institute
annamalai_university	annamalai_university
university_of_arizona	university_of_arizona
mount_royal_university	mount_royal_university
montclair_state_university	montclair_state_university
temple_university	temple_university
university_of_the_incarnate_word	university_of_the_incarnate_word
providence_college	providence_college
regis_college,_toronto	regis_college,_toronto
university_of_indianapolis	university_of_indianapolis
brooklyn_college	brooklyn_college
ural_state_university	ural_state_university
oxford_brookes_university	oxford_brookes_university
university_of_pittsburgh	university_of_pittsburgh
university_of_denver	university_of_denver
university_of_texas_at_austin	university_of_texas_at_austin
university_of_virginia	university_of_virginia
north_central_college	north_central_college
yerevan_state_university	yerevan_state_university
illinois_state_university	illinois_state_university
fisk_university	fisk_university
palomar_college	palomar_college
st._bonaventure_university	st._bonaventure_university
dowling_college	dowling_college
wake_forest_university	wake_forest_university
lewis_university	lewis_university
rhodes_university	rhodes_university
polytechnic_university_of_the_philippines	polytechnic_university_of_the_philippines
waseda_university	waseda_university
bond_university	bond_university
wheaton_college_(illinois)	wheaton_college_(illinois)
rissho_university	rissho_university
minnesota_state_university,_mankato	minnesota_state_university,_mankato
university_of_the_republic_(uruguay)	university_of_the_republic_(uruguay)
national_university_of_ireland	national_university_of_ireland
karadeniz_technical_university	karadeniz_technical_university
pacific_lutheran_university	pacific_lutheran_university
chodang_university	chodang_university
university_of_nigeria,_nsukka	university_of_nigeria,_nsukka
state_university_of_new_york_at_cobleskill	state_university_of_new_york_at_cobleskill
west_texas_a&m_university	west_texas_a&m_university
university_of_manitoba	university_of_manitoba
university_of_santo_tomas	university_of_santo_tomas
columbia_college_chicago	columbia_college_chicago
rider_university	rider_university
university_of_pamplona	university_of_pamplona
hanyang_women's_university	hanyang_women's_university
kean_university	kean_university
california_state_university,_fullerton	california_state_university,_fullerton
abertay_university	abertay_university
bradley_university	bradley_university
royal_holloway,_university_of_london	royal_holloway,_university_of_london
national_defence_university,_pakistan	national_defence_university,_pakistan
california_state_university,_sacramento	california_state_university,_sacramento
university_of_san_diego	university_of_san_diego
st._norbert_college	st._norbert_college
clayton_state_university	clayton_state_university
utrecht_university	utrecht_university
rutgers_university	rutgers_university
lebanon_valley_college	lebanon_valley_college
university_of_missouri	university_of_missouri
university_of_victoria	university_of_victoria
georgia_southern_university	georgia_southern_university
college_of_dupage	college_of_dupage
university_of_edinburgh	university_of_edinburgh
university_of_sheffield	university_of_sheffield
university_of_montevallo	university_of_montevallo
ball_state_university	ball_state_university
old_dominion_university	old_dominion_university
ceylon_medical_college	ceylon_medical_college
northwest_missouri_state_university	northwest_missouri_state_university
beijing_university_of_technology	beijing_university_of_technology
west_liberty_university	west_liberty_university
university_of_south_florida	university_of_south_florida
cleveland_state_university	cleveland_state_university
university_of_mobile	university_of_mobile
university_of_macau	university_of_macau
barnard_college	barnard_college
university_of_cincinnati	university_of_cincinnati
covenant_theological_seminary	covenant_theological_seminary
lindenwood_university	lindenwood_university
san_beda_college	san_beda_college
georgia_state_university	georgia_state_university
university_of_lagos	university_of_lagos
de_anza_college	de_anza_college
metropolitan_state_university_of_denver	metropolitan_state_university_of_denver
university_of_richmond	university_of_richmond
bellevue_college	bellevue_college
gonzaga_university	gonzaga_university
kwansei_gakuin_university	kwansei_gakuin_university
macalester_college	macalester_college
central_university_of_venezuela	central_university_of_venezuela
laurentian_university	laurentian_university
university_of_hartford	university_of_hartford
manhattanville_college	manhattanville_college
charles_darwin_university	charles_darwin_university
sam_houston_state_university	sam_houston_state_university
boston_university	boston_university
middlebury_college	middlebury_college
alcorn_state_university	alcorn_state_university
dalhousie_university	dalhousie_university
transylvania_university	transylvania_university
mercer_county_community_college	mercer_county_community_college
creighton_university	creighton_university
alderson_broaddus_university	alderson_broaddus_university
barry_university	barry_university
san_diego_state_university	san_diego_state_university
university_of_north_carolina_at_chapel_hill	university_of_north_carolina_at_chapel_hill
de_la_salle_university	de_la_salle_university
complutense_university_of_madrid	complutense_university_of_madrid
southeastern_louisiana_university	southeastern_louisiana_university
sungkyunkwan_university	sungkyunkwan_university
rowan_university	rowan_university
theresian_military_academy	theresian_military_academy
binghamton_university	binghamton_university
silliman_university	silliman_university
iowa_central_community_college	iowa_central_community_college
university_of_barcelona	university_of_barcelona
princeton_university	princeton_university
philippine_military_academy	philippine_military_academy
colorado_state_university	colorado_state_university
tokyo_gakugei_university	tokyo_gakugei_university
university_of_mount_union	university_of_mount_union
lipscomb_university	lipscomb_university
humber_college	humber_college
lahore_university_of_management_sciences	lahore_university_of_management_sciences
north_greenville_university	north_greenville_university
university_of_malaya	university_of_malaya
aoyama_gakuin_university	aoyama_gakuin_university
university_of_pennsylvania	university_of_pennsylvania
university_of_magdalena	university_of_magdalena
international_university_in_geneva	international_university_in_geneva
hogeschool_van_amsterdam	hogeschool_van_amsterdam
university_of_idaho	university_of_idaho
curtin_university	curtin_university
islamic_azad_university	islamic_azad_university
milligan_college	milligan_college
knox_college_(illinois)	knox_college_(illinois)
international_islamic_university_malaysia	international_islamic_university_malaysia
austin_college	austin_college
mcneese_state_university	mcneese_state_university
hongik_university	hongik_university
western_michigan_university	western_michigan_university
university_of_mumbai	university_of_mumbai
university_of_evansville	university_of_evansville
stanford_university	stanford_university
university_of_toronto	university_of_toronto
italian_naval_academy	italian_naval_academy
university_of_glasgow	university_of_glasgow
gujarat_university	gujarat_university
university_of_california,_irvine	university_of_california,_irvine
sree_kerala_varma_college	sree_kerala_varma_college
mercyhurst_university	mercyhurst_university
ithaca_college	ithaca_college
trent_university	trent_university
istanbul_technical_university	istanbul_technical_university
russian_academy_of_theatre_arts	russian_academy_of_theatre_arts
nova_southeastern_university	nova_southeastern_university
chinese_university_of_hong_kong	chinese_university_of_hong_kong
fitchburg_state_university	fitchburg_state_university
aichi_gakuin_university	aichi_gakuin_university
boston_college	boston_college
drew_university	drew_university
davis_&_elkins_college	davis_&_elkins_college
state_university_of_new_york_at_purchase	state_university_of_new_york_at_purchase
saint_petersburg_state_university	saint_petersburg_state_university
rensselaer_polytechnic_institute	rensselaer_polytechnic_institute
ryerson_university	ryerson_university
ateneo_de_manila_university	ateneo_de_manila_university
national_university_of_colombia	national_university_of_colombia
whitworth_university	whitworth_university
presidency_university,_kolkata	presidency_university,_kolkata
aalborg_university	aalborg_university
michigan_state_university	michigan_state_university
the_principia	the_principia
bowdoin_college	bowdoin_college
ohio_state_university	ohio_state_university
university_of_valle	university_of_valle
hofstra_university	hofstra_university
university_of_piura	university_of_piura
hillsdale_college	hillsdale_college
university_of_california,_berkeley	university_of_california,_berkeley
indian_military_academy	indian_military_academy
dean_college	dean_college
northwestern_university	northwestern_university
university_of_leicester	university_of_leicester
university_of_notre_dame	university_of_notre_dame
university_of_salford	university_of_salford
university_of_nevada,_las_vegas	university_of_nevada,_las_vegas
beijing_jiaotong_university	beijing_jiaotong_university
kyonggi_university	kyonggi_university
university_of_michigan	university_of_michigan
indiana_university	indiana_university
computer_laboratory,_university_of_cambridge	computer_laboratory,_university_of_cambridge
monroe_college	monroe_college
university_of_zambia	university_of_zambia
university_of_sri_jayewardenepura	university_of_sri_jayewardenepura
cosumnes_river_college	cosumnes_river_college
la_trobe_university	la_trobe_university
clemson_university	clemson_university
villanova_university	villanova_university
university_of_rochester	university_of_rochester
ateneo_de_davao_university	ateneo_de_davao_university
bocconi_university	bocconi_university
eindhoven_university_of_technology	eindhoven_university_of_technology
lund_university	lund_university
illinois_institute_of_technology	illinois_institute_of_technology
university_of_connecticut	university_of_connecticut
washington_university_in_st._louis	washington_university_in_st._louis
university_of_winnipeg	university_of_winnipeg
senshu_university	senshu_university
fresno_pacific_university	fresno_pacific_university
rockland_community_college	rockland_community_college
university_of_san_carlos	university_of_san_carlos
georgia_institute_of_technology	georgia_institute_of_technology
cornell_university	cornell_university
university_of_st_andrews	university_of_st_andrews
kansas_wesleyan_university	kansas_wesleyan_university
loras_college	loras_college
universitas_kristen_indonesia	universitas_kristen_indonesia
university_of_south_carolina_upstate	university_of_south_carolina_upstate
azusa_pacific_university	azusa_pacific_university
university_of_exeter	university_of_exeter
belmont_university	belmont_university
macquarie_university	macquarie_university
southampton_solent_university	southampton_solent_university
massachusetts_institute_of_technology	massachusetts_institute_of_technology
middle_tennessee_state_university	middle_tennessee_state_university
algonquin_college	algonquin_college
bethel_college_(indiana)	bethel_college_(indiana)
boston_state_college	boston_state_college
ashland_university	ashland_university
columbia_university_school_of_general_studies	columbia_university_school_of_general_studies
university_of_tirana	university_of_tirana
presbyterian_college	presbyterian_college
seton_hall_university	seton_hall_university
stony_brook_university	stony_brook_university
banff_centre	banff_centre
university_of_ibadan	university_of_ibadan
tanzania_military_academy	tanzania_military_academy
kwangwoon_university	kwangwoon_university
plekhanov_russian_university_of_economics	plekhanov_russian_university_of_economics
duke_university	duke_university
winthrop_university	winthrop_university
savannah_state_university	savannah_state_university
catawba_college	catawba_college
oberlin_college	oberlin_college
wilfrid_laurier_university	wilfrid_laurier_university
springfield_college_(massachusetts)	springfield_college_(massachusetts)
coastal_carolina_university	coastal_carolina_university
university_at_albany,_suny	university_at_albany,_suny
wayne_state_university	wayne_state_university
stetson_university	stetson_university
university_of_massachusetts_amherst	university_of_massachusetts_amherst
kalamazoo_college	kalamazoo_college
athabasca_university	athabasca_university
ucl_school_of_pharmacy	ucl_school_of_pharmacy
university_of_northern_iowa	university_of_northern_iowa
beijing_university_of_chemical_technology	beijing_university_of_chemical_technology
ramakrishna_mission_vivekananda_college	ramakrishna_mission_vivekananda_college
takushoku_university	takushoku_university
oklahoma_baptist_university	oklahoma_baptist_university
california_institute_of_technology	california_institute_of_technology
montreat_college	montreat_college
salt_lake_community_college	salt_lake_community_college
north_idaho_college	north_idaho_college
university_of_stuttgart	university_of_stuttgart
santa_clara_university	santa_clara_university
ceylon_university_college	ceylon_university_college
san_jose_state_university	san_jose_state_university
southern_polytechnic_state_university	southern_polytechnic_state_university
university_of_zululand	university_of_zululand
case_western_reserve_university	case_western_reserve_university
fort_lewis_college	fort_lewis_college
florida_state_university	florida_state_university
beihang_university	beihang_university
university_of_calgary	university_of_calgary
olivet_nazarene_university	olivet_nazarene_university
university_of_granada	university_of_granada
uppsala_university	uppsala_university
indiana_university_of_pennsylvania	indiana_university_of_pennsylvania
southern_illinois_university_carbondale	southern_illinois_university_carbondale
georgian_technical_university	georgian_technical_university
worcester_state_university	worcester_state_university
northern_arizona_university	northern_arizona_university
st._petersburg_college	st._petersburg_college
national_research_university_of_electronic_technology	national_research_university_of_electronic_technology
st._lawrence_university	st._lawrence_university
kyoto_university	kyoto_university
ottawa_university	ottawa_university
lynn_university	lynn_university
california_state_university,_northridge	california_state_university,_northridge
university_of_bridgeport	university_of_bridgeport
hanyang_university	hanyang_university
babson_college	babson_college
assumption_college_sriracha	assumption_college_sriracha
university_of_california,_santa_barbara	university_of_california,_santa_barbara
herkimer_county_community_college	herkimer_county_community_college
university_of_warsaw	university_of_warsaw
university_of_new_brunswick	university_of_new_brunswick
depauw_university	depauw_university
california_state_university,_bakersfield	california_state_university,_bakersfield
franklin_&_marshall_college	franklin_&_marshall_college
millikin_university	millikin_university
university_of_groningen	university_of_groningen
university_of_texas_at_san_antonio	university_of_texas_at_san_antonio
national_taiwan_normal_university	national_taiwan_normal_university
university_of_guelph	university_of_guelph
austin_peay_state_university	austin_peay_state_university
syracuse_university	syracuse_university
universiti_teknologi_malaysia	universiti_teknologi_malaysia
pontifical_catholic_university_of_chile	pontifical_catholic_university_of_chile
university_of_akron	university_of_akron
lamar_university	lamar_university
graceland_university	graceland_university
florida_a&m_university	florida_a&m_university
stephen_f._austin_state_university	stephen_f._austin_state_university
jacksonville_university	jacksonville_university
university_of_texas_at_brownsville	university_of_texas_at_brownsville
spelman_college	spelman_college
manipal_institute_of_technology	manipal_institute_of_technology
university_of_pretoria	university_of_pretoria
clarkson_university	clarkson_university
hood_college	hood_college
university_of_southampton	university_of_southampton
saint_mary's_university_of_minnesota	saint_mary's_university_of_minnesota
leipzig_university	leipzig_university
mckendree_university	mckendree_university
pfeiffer_university	pfeiffer_university
university_of_calcutta	university_of_calcutta
california_state_university,_fresno	california_state_university,_fresno
psg_college_of_technology	psg_college_of_technology
hastings_college	hastings_college
william_carey_university	william_carey_university
elizabethtown_college	elizabethtown_college
aston_university	aston_university
keio_university	keio_university
saint_anselm_college	saint_anselm_college
university_of_rhode_island	university_of_rhode_island
swinburne_university_of_technology	swinburne_university_of_technology
illinois_wesleyan_university	illinois_wesleyan_university
university_of_the_pacific_(united_states)	university_of_the_pacific_(united_states)
korea_university	korea_university
san_diego_mesa_college	san_diego_mesa_college
university_of_utah	university_of_utah
university_of_otago	university_of_otago
state_university_of_new_york_at_oneonta	state_university_of_new_york_at_oneonta
united_states_naval_academy	united_states_naval_academy
marymount_california_university	marymount_california_university
colgate_university	colgate_university
digipen_institute_of_technology	digipen_institute_of_technology
university_of_hertfordshire	university_of_hertfordshire
marquette_university	marquette_university
davidson_college	davidson_college
gauhati_university	gauhati_university
baruch_college	baruch_college
university_of_natal	university_of_natal
university_of_madras	university_of_madras
averett_university	averett_university
notre_dame_college	notre_dame_college
johnson_county_community_college	johnson_county_community_college
loyola_marymount_university	loyola_marymount_university
aurora_university	aurora_university
the_citadel,_the_military_college_of_south_carolina	the_citadel,_the_military_college_of_south_carolina
university_of_deusto	university_of_deusto
rogers_state_university	rogers_state_university
delft_university_of_technology	delft_university_of_technology
lee_university	lee_university
zhejiang_university	zhejiang_university
university_of_bradford	university_of_bradford
albright_college	albright_college
hrodna_state_university	hrodna_state_university
boise_state_university	boise_state_university
university_of_shanghai	university_of_shanghai
university_of_tampa	university_of_tampa
randolph_college	randolph_college
florida_international_university	florida_international_university
visva-bharati_university	visva-bharati_university
leiden_university	leiden_university
lithuanian_university_of_health_sciences	lithuanian_university_of_health_sciences
university_of_illinois_at_springfield	university_of_illinois_at_springfield
american_river_college	american_river_college
wright_state_university	wright_state_university
belhaven_university	belhaven_university
university_of_derby	university_of_derby
howard_university	howard_university
university_of_southern_mississippi	university_of_southern_mississippi
university_of_western_ontario	university_of_western_ontario
st._michael's_college,_toronto	st._michael's_college,_toronto
belmont_abbey_college	belmont_abbey_college
bluffton_university	bluffton_university
elgin_community_college	elgin_community_college
university_of_south_carolina_aiken	university_of_south_carolina_aiken
the_catholic_university_of_america	the_catholic_university_of_america
city_university_london	city_university_london
augsburg_college	augsburg_college
university_of_louisville	university_of_louisville
joseph_fourier_university	joseph_fourier_university
university_of_vermont	university_of_vermont
garden_city_community_college	garden_city_community_college
manuel_l._quezon_university	manuel_l._quezon_university
semmelweis_university	semmelweis_university
university_college_dublin	university_college_dublin
furman_university	furman_university
purdue_university	purdue_university
bangkok_university	bangkok_university
chukyo_university	chukyo_university
concordia_university	concordia_university
shorter_university	shorter_university
west_virginia_wesleyan_college	west_virginia_wesleyan_college
national_university_of_san_marcos	national_university_of_san_marcos
western_kentucky_university	western_kentucky_university
queen's_university	queen's_university
oregon_state_university	oregon_state_university
university_of_massachusetts_lowell	university_of_massachusetts_lowell
loma_linda_university	loma_linda_university
florida_southern_college	florida_southern_college
franklin_pierce_university	franklin_pierce_university
jabalpur_engineering_college	jabalpur_engineering_college
cardiff_metropolitan_university	cardiff_metropolitan_university
saint_louis_university	saint_louis_university
hampton_university	hampton_university
dallas_baptist_university	dallas_baptist_university
sindh_muslim_law_college	sindh_muslim_law_college
american_international_college	american_international_college
coker_college	coker_college
royal_institute_of_technology	royal_institute_of_technology
imperial_college_london	imperial_college_london
new_york_university	new_york_university
cornell_college	cornell_college
union_university	union_university
the_college_of_new_jersey	the_college_of_new_jersey
michigan_technological_university	michigan_technological_university
st._augustine's_university	st._augustine's_university
franciscan_university_of_steubenville	franciscan_university_of_steubenville
robert_morris_university	robert_morris_university
lawrence_university	lawrence_university
university_of_kent	university_of_kent
san_francisco_state_university	san_francisco_state_university
seoul_national_university	seoul_national_university
vilnius_university	vilnius_university
international_christian_university	international_christian_university
brandeis_university	brandeis_university
radboud_university_nijmegen	radboud_university_nijmegen
bard_college	bard_college
rio_hondo_college	rio_hondo_college
soas,_university_of_london	soas,_university_of_london
rwth_aachen_university	rwth_aachen_university
rwth_aachen_university	colorado_state_university
thomas_university	thomas_university
university_of_melbourne	university_of_melbourne
dongguk_university	dongguk_university
sapienza_university_of_rome	sapienza_university_of_rome
virginia_wesleyan_college	virginia_wesleyan_college
universidad_iberoamericana	universidad_iberoamericana
ca'_foscari_university_of_venice	ca'_foscari_university_of_venice
virginia_commonwealth_university	virginia_commonwealth_university
arcadia_university	arcadia_university
university_of_baltimore	university_of_baltimore
wiregrass_georgia_technical_college	wiregrass_georgia_technical_college
angelo_state_university	angelo_state_university
montana_state_university_billings	montana_state_university_billings
emory_university	emory_university
university_of_bristol	university_of_bristol
eckerd_college	eckerd_college
curry_college	curry_college
mount_st._mary's_university	mount_st._mary's_university
university_of_new_mexico	university_of_new_mexico
university_of_california,_los_angeles	university_of_california,_los_angeles
bryant_university	bryant_university
park_university	park_university
saint_francis_university	saint_francis_university
trinity_western_university	trinity_western_university
ohio_northern_university	ohio_northern_university
brown_university	brown_university
university_of_gothenburg	university_of_gothenburg
chernivtsi_university	chernivtsi_university
sun_moon_university	sun_moon_university
tuskegee_university	tuskegee_university
riverland_community_college	riverland_community_college
hunter_college	hunter_college
university_of_hong_kong	university_of_hong_kong
university_of_sindh	university_of_sindh
yale_university	yale_university
los_angeles_mission_college	los_angeles_mission_college
winona_state_university	winona_state_university
university_of_north_carolina_at_asheville	university_of_north_carolina_at_asheville
fairleigh_dickinson_university	fairleigh_dickinson_university
grambling_state_university	grambling_state_university
skyline_college	skyline_college
erskine_college	erskine_college
university_of_illinois_at_chicago	university_of_illinois_at_chicago
southern_methodist_university	southern_methodist_university
university_of_north_texas	university_of_north_texas
university_of_south_carolina	university_of_south_carolina
tennessee_state_university	tennessee_state_university
gustavus_adolphus_college	gustavus_adolphus_college
barton_college	barton_college
madras_medical_college	madras_medical_college
university_of_san_francisco	university_of_san_francisco
california_polytechnic_state_university	california_polytechnic_state_university
university_of_westminster	university_of_westminster
university_of_california,_davis	university_of_california,_davis
brenau_university	brenau_university
university_of_the_western_cape	university_of_the_western_cape
fluminense_federal_university	fluminense_federal_university
sangji_university	sangji_university
university_of_georgia	university_of_georgia
lincoln_memorial_university	lincoln_memorial_university
new_york_law_school	new_york_law_school
university_of_northampton	university_of_northampton
united_states_air_force_academy	united_states_air_force_academy
community_college_of_philadelphia	community_college_of_philadelphia
pasadena_city_college	pasadena_city_college
chalmers_university_of_technology	chalmers_university_of_technology
georgia_military_college	georgia_military_college
east_los_angeles_college	east_los_angeles_college
greensboro_college	greensboro_college
quinnipiac_university	quinnipiac_university
university_of_ghana	university_of_ghana
pachaiyappa's_college	pachaiyappa's_college
berry_college	berry_college
middle_east_technical_university	middle_east_technical_university
chosun_university	chosun_university
alliant_international_university	alliant_international_university
washburn_university	washburn_university
kennesaw_state_university	kennesaw_state_university
national_chengchi_university	national_chengchi_university
catholic_university_of_portugal	catholic_university_of_portugal
santa_rosa_junior_college	santa_rosa_junior_college
laval_university	laval_university
birkbeck,_university_of_london	birkbeck,_university_of_london
california_state_university,_chico	california_state_university,_chico
lewis_&_clark_college	lewis_&_clark_college
university_of_wales	university_of_wales
georgetown_university	georgetown_university
auburn_university	auburn_university
campbell_university	campbell_university
trinity_university_(texas)	trinity_university_(texas)
ahmadu_bello_university	ahmadu_bello_university
pontifical_gregorian_university	pontifical_gregorian_university
vassar_college	vassar_college
millersville_university_of_pennsylvania	millersville_university_of_pennsylvania
seattle_university	seattle_university
centre_college	centre_college
university_of_szczecin	university_of_szczecin
cumberland_university	cumberland_university
university_of_stirling	university_of_stirling
mount_vernon_nazarene_university	mount_vernon_nazarene_university
university_of_the_west_of_england	university_of_the_west_of_england
louisiana_state_university	louisiana_state_university
presidency_college,_chennai	presidency_college,_chennai
houghton_college	houghton_college
college_of_the_ozarks	college_of_the_ozarks
yonsei_university	yonsei_university
williams_college	williams_college
university_of_california,_riverside	university_of_california,_riverside
texas_christian_university	texas_christian_university
manipal_university	manipal_university
mercer_university	mercer_university
birzeit_university	birzeit_university
hendrix_college	hendrix_college
southern_nazarene_university	southern_nazarene_university
baker_university	baker_university
southern_utah_university	southern_utah_university
oral_roberts_university	oral_roberts_university
nassau_community_college	nassau_community_college
mcmaster_university	mcmaster_university
point_loma_nazarene_university	point_loma_nazarene_university
hacettepe_university	hacettepe_university
chicago_state_university	chicago_state_university
kabul_university	kabul_university
schoolcraft_college	schoolcraft_college
chapman_university	chapman_university
university_of_libya	university_of_libya
stevens_institute_of_technology	stevens_institute_of_technology
widener_university	widener_university
national_central_university	national_central_university
midwestern_state_university	midwestern_state_university
pitzer_college	pitzer_college
agricultural_university_of_tirana	agricultural_university_of_tirana
university_of_texas_at_dallas	university_of_texas_at_dallas
mississippi_state_university	mississippi_state_university
dartmouth_college	dartmouth_college
university_of_washington	university_of_washington
st._edward's_university	st._edward's_university
el_camino_college	el_camino_college
moscow_aviation_institute	moscow_aviation_institute
university_of_alberta	university_of_alberta
xavier_university	xavier_university
polk_state_college	polk_state_college
trinity_college,_toronto	trinity_college,_toronto
university_of_szeged	university_of_szeged
bowling_green_state_university	bowling_green_state_university
elon_university	elon_university
shimer_college	shimer_college
wingate_university	wingate_university
langara_college	langara_college
jadavpur_university	jadavpur_university
fairfield_university	fairfield_university
lindsey_wilson_college	lindsey_wilson_college
indiana_university_bloomington	indiana_university_bloomington
colorado_college	colorado_college
south_ural_state_university	south_ural_state_university
southern_illinois_university_edwardsville	southern_illinois_university_edwardsville
stellenbosch_university	stellenbosch_university
foothill_college	foothill_college
san_diego_miramar_college	san_diego_miramar_college
linfield_college	linfield_college
georgia_southwestern_state_university	georgia_southwestern_state_university
sri_jayachamarajendra_college_of_engineering	sri_jayachamarajendra_college_of_engineering
wharton_school_of_the_university_of_pennsylvania	wharton_school_of_the_university_of_pennsylvania
university_of_memphis	university_of_memphis
taylor_university	taylor_university
university_of_freiburg	university_of_freiburg
macmurray_college	macmurray_college
high_point_university	high_point_university
southern_new_hampshire_university	southern_new_hampshire_university
university_of_tennessee	university_of_tennessee
ferris_state_university	ferris_state_university
universidad_externado_de_colombia	universidad_externado_de_colombia
concordia_university_(oregon)	concordia_university_(oregon)
king's_college_london	king's_college_london
harvard_medical_school	harvard_medical_school
kyung_hee_university	kyung_hee_university
medaille_college	medaille_college
palm_beach_atlantic_university	palm_beach_atlantic_university
asbury_university	asbury_university
university_of_sussex	university_of_sussex
whitman_college	whitman_college
virginia_military_institute	virginia_military_institute
northern_illinois_university	northern_illinois_university
california_state_university,_dominguez_hills	california_state_university,_dominguez_hills
konkuk_university	konkuk_university
university_for_foreigners_perugia	university_for_foreigners_perugia
silpakorn_university	silpakorn_university
westchester_community_college	westchester_community_college
university_of_the_city_of_manila	university_of_the_city_of_manila
national_university_of_trujillo	national_university_of_trujillo
siena_college	siena_college
cape_fear_community_college	cape_fear_community_college
academy_of_art_university	academy_of_art_university
technical_university_of_dortmund	technical_university_of_dortmund
indian_institute_of_management_calcutta	indian_institute_of_management_calcutta
tianjin_university	tianjin_university
adelphi_university	adelphi_university
thammasat_university	thammasat_university
james_madison_university	james_madison_university
nelson_mandela_metropolitan_university	nelson_mandela_metropolitan_university
mesa_community_college	mesa_community_college
pennsylvania_state_university	pennsylvania_state_university
vu_university_amsterdam	vu_university_amsterdam
towson_university	towson_university
drexel_university	drexel_university
washington_state_university	washington_state_university
university_of_california,_san_diego	university_of_california,_san_diego
university_of_auckland	university_of_auckland
occidental_college	occidental_college
polytechnic_university_of_milan	polytechnic_university_of_milan
united_states_military_academy	united_states_military_academy
augusta_state_university	augusta_state_university
university_of_strathclyde	university_of_strathclyde
east_stroudsburg_university_of_pennsylvania	east_stroudsburg_university_of_pennsylvania
simon_fraser_university	simon_fraser_university
salisbury_university	salisbury_university
cheikh_anta_diop_university	cheikh_anta_diop_university
texas_tech_university	texas_tech_university
dakota_wesleyan_university	dakota_wesleyan_university
regis_university	regis_university
university_of_florida	university_of_florida
state_university_of_new_york_at_fredonia	state_university_of_new_york_at_fredonia
iowa_state_university	iowa_state_university
rochester_institute_of_technology	rochester_institute_of_technology
kent_state_university	kent_state_university
pomona_college	pomona_college
university_of_malta	university_of_malta
indian_institute_of_technology_madras	indian_institute_of_technology_madras
sonoma_state_university	sonoma_state_university
saint_mary's_college_of_california	saint_mary's_college_of_california
university_of_waterloo	university_of_waterloo
manila_central_university	manila_central_university
lincoln_university_(pennsylvania)	lincoln_university_(pennsylvania)
southern_adventist_university	southern_adventist_university
capilano_university	capilano_university
north_carolina_central_university	north_carolina_central_university
new_jersey_city_university	new_jersey_city_university
university_of_navarra	university_of_navarra
university_of_the_district_of_columbia	university_of_the_district_of_columbia
beloit_college	beloit_college
dominica_state_college	dominica_state_college
american_university	american_university
grand_canyon_university	grand_canyon_university
university_of_east_anglia	university_of_east_anglia
allahabad_university	allahabad_university
austin_community_college_district	austin_community_college_district
liberty_university	liberty_university
ohio_wesleyan_university	ohio_wesleyan_university
loyola_university_chicago	loyola_university_chicago
james_cook_university	james_cook_university
maryville_college	maryville_college
miami_university	miami_university
monash_university	monash_university
mines_paristech	mines_paristech
berea_college	berea_college
eastern_michigan_university	eastern_michigan_university
university_of_portland	university_of_portland
sarah_lawrence_college	sarah_lawrence_college
longwood_university	longwood_university
emerson_college	emerson_college
liverpool_school_of_tropical_medicine	liverpool_school_of_tropical_medicine
fresno_city_college	fresno_city_college
university_of_delaware	university_of_delaware
nihon_university	nihon_university
carleton_college	carleton_college
cedarville_university	cedarville_university
west_virginia_university	west_virginia_university
college_of_southern_maryland	college_of_southern_maryland
university_of_johannesburg	university_of_johannesburg
university_of_the_witwatersrand	university_of_the_witwatersrand
parsons_college	parsons_college
saint_michael's_college	saint_michael's_college
university_of_st._gallen	university_of_st._gallen
wabash_college	wabash_college
king_university	king_university
harvard_university	harvard_university
bucknell_university	bucknell_university
jagiellonian_university	jagiellonian_university
tusculum_college	tusculum_college
university_of_colorado_boulder	university_of_colorado_boulder
i-shou_university	i-shou_university
university_of_alabama_at_birmingham	university_of_alabama_at_birmingham
university_of_maryland,_college_park	university_of_maryland,_college_park
champlain_college	champlain_college
university_of_alabama_in_huntsville	university_of_alabama_in_huntsville
vanderbilt_university	vanderbilt_university
columbia_university	columbia_university
warsaw_school_of_economics	warsaw_school_of_economics
st._ambrose_university	st._ambrose_university
university_of_lucknow	university_of_lucknow
carleton_university	carleton_university
lehigh_university	lehigh_university
central_washington_university	central_washington_university
canisius_college	canisius_college
university_of_british_columbia	university_of_british_columbia
asia_europe_university	asia_europe_university
christopher_newport_university	christopher_newport_university
california_lutheran_university	california_lutheran_university
millsaps_college	millsaps_college
bryant_&_stratton_college	bryant_&_stratton_college
brevard_college	brevard_college
arizona_state_university	arizona_state_university
tunghai_university	tunghai_university
fu_jen_catholic_university	fu_jen_catholic_university
pakistan_military_academy	pakistan_military_academy
glasgow_caledonian_university	glasgow_caledonian_university
florida_institute_of_technology	florida_institute_of_technology
st._john's_university_(new_york_city)	st._john's_university_(new_york_city)
university_of_tennessee_at_chattanooga	university_of_tennessee_at_chattanooga
nippon_sport_science_university	nippon_sport_science_university
momoyama_gakuin_university	momoyama_gakuin_university
western_illinois_university	western_illinois_university
geneva_college	geneva_college
serampore_college	serampore_college
long_beach_city_college	long_beach_city_college
central_connecticut_state_university	central_connecticut_state_university
acadia_university	acadia_university
university_of_central_florida	university_of_central_florida
university_of_montana	university_of_montana
rikkyo_university	rikkyo_university
brigham_young_university	brigham_young_university
university_of_detroit_mercy	university_of_detroit_mercy
george_mason_university	george_mason_university
york_university	york_university
college_of_engineering,_trivandrum	college_of_engineering,_trivandrum
oklahoma_city_university	oklahoma_city_university
university_of_costa_rica	university_of_costa_rica
chulachomklao_royal_military_academy	chulachomklao_royal_military_academy
sheffield_hallam_university	sheffield_hallam_university
bloomsburg_university_of_pennsylvania	bloomsburg_university_of_pennsylvania
southern_connecticut_state_university	southern_connecticut_state_university
colorado_school_of_mines	colorado_school_of_mines
north_carolina_state_university	north_carolina_state_university
valparaiso_university	valparaiso_university
union_college	union_college
university_of_southern_indiana	university_of_southern_indiana
biola_university	biola_university
lyceum_of_the_philippines_university	lyceum_of_the_philippines_university
southern_wesleyan_university	southern_wesleyan_university
seattle_pacific_university	seattle_pacific_university
clark_university	clark_university
saint_joseph's_university	saint_joseph's_university
texas_southern_university	texas_southern_university
wilberforce_university	wilberforce_university
meiji_university	meiji_university
blackstone_college_for_girls	blackstone_college_for_girls
university_of_southern_california	university_of_southern_california