takuya_kirimoto	takuya_kirimoto
jacqueline_lorains	jacqueline_lorains
harry_fielder	harry_fielder
christian_casadesus	christian_casadesus
samantha_bentley	samantha_bentley
allysin_chaynes	allysin_chaynes
roger_griffiths	roger_griffiths
leanne_li	leanne_li
ulf_palme	ulf_palme
satomi_hanamura	satomi_hanamura
lawson_butt	lawson_butt
candy_hsu	candy_hsu
feng_gong	feng_gong
jean_coquelin	jean_coquelin
margot_boyd	margot_boyd
alice_tzeng	alice_tzeng
jessica_benton	jessica_benton
min_tanaka	min_tanaka
masato_yamanouchi	masato_yamanouchi
prince_yahshua	prince_yahshua
masayo_kurata	masayo_kurata
peter_birch_(actor)	peter_birch_(actor)
jordan_murphy_(english_actor)	jordan_murphy_(english_actor)
ann-marie_gyllenspetz	ann-marie_gyllenspetz
colin_keith-johnston	colin_keith-johnston
brandy_talore	brandy_talore
masami_iwasaki	masami_iwasaki
jean_bradin	jean_bradin
jo_warne	jo_warne
melvin_sia	melvin_sia
nikita_denise	nikita_denise
keith_faulkner	keith_faulkner
rio_mariah	rio_mariah
victor_huang	victor_huang
daniel_duval	daniel_duval
griffith_jones_(actor)	griffith_jones_(actor)
kelly_cheung	kelly_cheung
danny_lopes	danny_lopes
mayumi_yoshida	mayumi_yoshida
takuya_eguchi	takuya_eguchi
gilly_coman	gilly_coman
hideo_kanze	hideo_kanze
simon_paisley_day	simon_paisley_day
sandy_dempsey	sandy_dempsey
john_shum	john_shum
dagmar_ebbesen	dagmar_ebbesen
hidetoshi_nishijima_(actor)	hidetoshi_nishijima_(actor)
yasuko_tomita	yasuko_tomita
kazuhisa_kawahara_(actor)	kazuhisa_kawahara_(actor)
bramwell_fletcher	bramwell_fletcher
philip_ray	philip_ray
brooke_ashley	brooke_ashley
brandon_iron	brandon_iron
takuma_terashima	takuma_terashima
bert_tracy	bert_tracy
elena_kong	elena_kong
ofo_uhiara	ofo_uhiara
karen_meagher	karen_meagher
stephy_tang	stephy_tang
olivia_o'lovely	olivia_o'lovely
hotaru_akane	hotaru_akane
marika_green	marika_green
tommy_pistol	tommy_pistol
kelly_divine	kelly_divine
chad_hunt	chad_hunt
geoffrey_beevers	geoffrey_beevers
kazuyo_aoki	kazuyo_aoki
mayako_nigo	mayako_nigo
eileen_o'brien_(actress)	eileen_o'brien_(actress)
terence_cooper	terence_cooper
sammul_chan	sammul_chan
kent_riley	kent_riley
hal_gordon	hal_gordon
anri_shiono	anri_shiono
kinzie_kenner	kinzie_kenner
kanna_mori	kanna_mori
david_quilter	david_quilter
clive_ashborn	clive_ashborn
hikaru_koto	hikaru_koto
leena_la_bianca	leena_la_bianca
hikari_tachibana	hikari_tachibana
kazuyuki_sogabe	kazuyuki_sogabe
daisy_beaumont	daisy_beaumont
tina_tyler	tina_tyler
feng_shaofeng	feng_shaofeng
marjorie_monaghan	marjorie_monaghan
susanne_thorson	susanne_thorson
nadia_barentin	nadia_barentin
jack_purvis_(actor)	jack_purvis_(actor)
caressa_savage	caressa_savage
edmund_pegge	edmund_pegge
he_meitian	he_meitian
fiona_chalmers	fiona_chalmers
cameron_hall_(actor)	cameron_hall_(actor)
dolly_golden	dolly_golden
shinichiro_ohta	shinichiro_ohta
fredrik_gunnarsson	fredrik_gunnarsson
lee_wei	lee_wei
lam_ching-ying	lam_ching-ying
eva_sayer	eva_sayer
dexter_young	dexter_young
alex_fong_(singer)	alex_fong_(singer)
bernard_campan	bernard_campan
pierre_fitch	pierre_fitch
lionelle_howard	lionelle_howard
james_knight_(actor)	james_knight_(actor)
mike_packer	mike_packer
godfrey_gao	godfrey_gao
yasuo_tanaka_(voice_actor)	yasuo_tanaka_(voice_actor)
alexander_field_(actor)	alexander_field_(actor)
fred_groves_(actor)	fred_groves_(actor)
emi_motoi	emi_motoi
tom_judson	tom_judson
azumi_kawashima	azumi_kawashima
ann-mari_adamsson	ann-mari_adamsson
sam_beazley	sam_beazley
jakob_eklund	jakob_eklund
joan_chen	joan_chen
tamaki_nakanishi	tamaki_nakanishi
germaine_michel	germaine_michel
inday_ba	inday_ba
tomoko_ishimura	tomoko_ishimura
kitty_clive	kitty_clive
ashley_blue	ashley_blue
lucinda_kennard	lucinda_kennard
john_axel_eriksson	john_axel_eriksson
anthony_oliver	anthony_oliver
sayuri_hara	sayuri_hara
asuka_hoshino	asuka_hoshino
tony_liu	tony_liu
david_dixon	david_dixon
henry_hallett	henry_hallett
cedric_smith_(actor)	cedric_smith_(actor)
danuta_lato	danuta_lato
athole_stewart	athole_stewart
jenna_haze	jenna_haze
ken_lo	ken_lo
ni_ping	ni_ping
phyllis_stanley	phyllis_stanley
chigusa_takaku	chigusa_takaku
megan_zheng	megan_zheng
jo-anne_knowles	jo-anne_knowles
trevor_dwyer-lynch	trevor_dwyer-lynch
mirai_yamamoto	mirai_yamamoto
henry_caine	henry_caine
terry_scully	terry_scully
rumi_ochiai	rumi_ochiai
marin_gerrier	marin_gerrier
stina_ekblad	stina_ekblad
morton_selten	morton_selten
chris_stone_(actor)	chris_stone_(actor)
kim_peacock	kim_peacock
taija_rae	taija_rae
anne-marie_brunius	anne-marie_brunius
per_myrberg	per_myrberg
william_margold	william_margold
terry_walsh_(actor)	terry_walsh_(actor)
alexis_dubus	alexis_dubus
angiolo_vestris	angiolo_vestris
marylin_star	marylin_star
marcel_bozzuffi	marcel_bozzuffi
tina_russell	tina_russell
alex_mcsweeney	alex_mcsweeney
nina_li_(actress)	nina_li_(actress)
paul_chequer	paul_chequer
john_salew	john_salew
richard_leaf	richard_leaf
angel_dark	angel_dark
bertie_wright	bertie_wright
irene_sunters	irene_sunters
johnson_lee	johnson_lee
nicholas_phipps	nicholas_phipps
zhou_jie	zhou_jie
chiaki_morita	chiaki_morita
affif_ben_badra	affif_ben_badra
pamela_mann	pamela_mann
primi_townsend	primi_townsend
eve_balfour_(actress)	eve_balfour_(actress)
cora_miao	cora_miao
dan_tullis_jr.	dan_tullis_jr.
catherine_hansson	catherine_hansson
dag_malmberg	dag_malmberg
a._harding_steerman	a._harding_steerman
chad_donovan	chad_donovan
paul_valentine	paul_valentine
edith_ker	edith_ker
emi_wakui	emi_wakui
doris_svedlund	doris_svedlund
maurice_chevit	maurice_chevit
amanda_fahy	amanda_fahy
billy_l._sullivan	billy_l._sullivan
dudley_foster	dudley_foster
thom_barron	thom_barron
maxi_iglesias	maxi_iglesias
colin_rix	colin_rix
mickey_he	mickey_he
fuyumi_shiraishi	fuyumi_shiraishi
bridget_turner	bridget_turner
brandon_lee_(pornographic_actor)	brandon_lee_(pornographic_actor)
dorothy_seacombe	dorothy_seacombe
coralie_trinh_thi	coralie_trinh_thi
stig_grybe	stig_grybe
john_hallet	john_hallet
benjamin_yuen	benjamin_yuen
saya_takagi	saya_takagi
miao_pu	miao_pu
kiki_sheung	kiki_sheung
alina_plugaru	alina_plugaru
dayo_wong	dayo_wong
erina_nakayama	erina_nakayama
katherine_parr_(actress)	katherine_parr_(actress)
marina_kuroki	marina_kuroki
laura_crossley	laura_crossley
arthur_riscoe	arthur_riscoe
michelle_maylene	michelle_maylene
sumie_sakai_(voice_actress)	sumie_sakai_(voice_actress)
cat_simmons	cat_simmons
david_oxley	david_oxley
mami_nomura	mami_nomura
sinnamon_love	sinnamon_love
william_lindsay_(actor)	william_lindsay_(actor)
gregory_scott	gregory_scott
sybil_grove	sybil_grove
stafford_gordon	stafford_gordon
briana_blair	briana_blair
melissa_hill	melissa_hill
lee_heung-kam	lee_heung-kam
kenpachiro_satsuma	kenpachiro_satsuma
melanie_walters	melanie_walters
sonija_kwok	sonija_kwok
sydney_bromley	sydney_bromley
christopher_doyle	christopher_doyle
andrea_green	andrea_green
mike_south	mike_south
tiffany_tang	tiffany_tang
harold_lang_(actor)	harold_lang_(actor)
laura_koffman	laura_koffman
lloyd_mcguire	lloyd_mcguire
cameron_carr_(actor)	cameron_carr_(actor)
molly_peters	molly_peters
mai_goto_(voice_actress)	mai_goto_(voice_actress)
rumi_kasahara	rumi_kasahara
jyunichi_haruta	jyunichi_haruta
tsutomu_kashiwakura	tsutomu_kashiwakura
edward_o'neill_(actor)	edward_o'neill_(actor)
mickey_g.	mickey_g.
kitty_foxx	kitty_foxx
yukimasa_obi	yukimasa_obi
juju_chan	juju_chan
jackie_lane_(actress)	jackie_lane_(actress)
sonia_holm	sonia_holm
jesse_capelli	jesse_capelli
gia_paloma	gia_paloma
henry_bergman	henry_bergman
long_dong_silver	long_dong_silver
eddie_leslie	eddie_leslie
toshiki_masuda	toshiki_masuda
jacques_dumesnil	jacques_dumesnil
takako_tokiwa	takako_tokiwa
tania_mallet	tania_mallet
john_fawcett_(actor)	john_fawcett_(actor)
jean-louis_richard	jean-louis_richard
anthony_eustrel	anthony_eustrel
sarah_patterson	sarah_patterson
ryo_ryusei	ryo_ryusei
mickey_brantford	mickey_brantford
sian_webber	sian_webber
hideyo_fujita	hideyo_fujita
tor_isedal	tor_isedal
jacquie_lyn	jacquie_lyn
jane_wade	jane_wade
mieko_harada	mieko_harada
christer_flodin	christer_flodin
jennifer_daniel	jennifer_daniel
haruka_yamazaki	haruka_yamazaki
fillip_williams	fillip_williams
marcia_warren	marcia_warren
barbara_couper	barbara_couper
wallas_eaton	wallas_eaton
lily_saxby	lily_saxby
ulla_akselson	ulla_akselson
anthony_murphy_(actor)	anthony_murphy_(actor)
keiko_kishi	keiko_kishi
sunrise_adams	sunrise_adams
monica_nielsen	monica_nielsen
raymond_souplex	raymond_souplex
yuan_hong_(actor)	yuan_hong_(actor)
john_cheng	john_cheng
sally_geoghegan	sally_geoghegan
yui_itsuki	yui_itsuki
felicia_chin	felicia_chin
sybil_arundale	sybil_arundale
sally_knyvette	sally_knyvette
jullan_kindahl	jullan_kindahl
xu_jinglei	xu_jinglei
rika_kawamura	rika_kawamura
glennis_lorimer	glennis_lorimer
alexander_devoe	alexander_devoe
margreth_weivers	margreth_weivers
race_wong	race_wong
kika_markham	kika_markham
mi_ridell	mi_ridell
madison_young	madison_young
gunnar_olsson_(actor)	gunnar_olsson_(actor)
minami_tsuda	minami_tsuda
audrey_fildes	audrey_fildes
lynette_mettey	lynette_mettey
steve_hatcher	steve_hatcher
kit_chan	kit_chan
robert_party	robert_party
hou_yaowen	hou_yaowen
josephine_alhanko	josephine_alhanko
tzi_ma	tzi_ma
vera_day	vera_day
jennifer_metcalfe	jennifer_metcalfe
toshiyuki_toyonaga	toshiyuki_toyonaga
noriko_rikimaru	noriko_rikimaru
yuri_komuro	yuri_komuro
mamiko_tayama	mamiko_tayama
rayson_tan	rayson_tan
susan_tse	susan_tse
keith_hodiak	keith_hodiak
hiromi_konno	hiromi_konno
ann-marie_wiman	ann-marie_wiman
hugh_cross	hugh_cross
rio_akisada	rio_akisada
terence_siufay	terence_siufay
hiroshi_fujioka	hiroshi_fujioka
nina_hartley	nina_hartley
inga_gill	inga_gill
lilian_johansson	lilian_johansson
geoffrey_lumsden	geoffrey_lumsden
keiichi_noda	keiichi_noda
roy_north	roy_north
jun_tazaki	jun_tazaki
minoru_tanaka_(actor)	minoru_tanaka_(actor)
barrett_long	barrett_long
arnaud_ducret	arnaud_ducret
ramez_galal	ramez_galal
hiromi_matsuura	hiromi_matsuura
cavin_soh	cavin_soh
yoko_akino	yoko_akino
cecil_del_gue	cecil_del_gue
vanilla_yamazaki	vanilla_yamazaki
yang_mi	yang_mi
misa_watanabe	misa_watanabe
jean-marie_winling	jean-marie_winling
morgan_andersson	morgan_andersson
izumi_kitta	izumi_kitta
lis_nilheim	lis_nilheim
diane_grayson	diane_grayson
arnold_bell	arnold_bell
tag_adams	tag_adams
tomoko_naraoka	tomoko_naraoka
yoshino_takamori	yoshino_takamori
robert_dawes	robert_dawes
sakurako_kaoru	sakurako_kaoru
akira_emoto	akira_emoto
justin_deas	justin_deas
philippe_nahon	philippe_nahon
roland_hedlund	roland_hedlund
tsunehiko_watase	tsunehiko_watase
charlie_brill	charlie_brill
ann_casson	ann_casson
marc_culwick	marc_culwick
carrie_ng	carrie_ng
umi_tenjin	umi_tenjin
cathryn_harrison	cathryn_harrison
bianca_soares	bianca_soares
rose_alba	rose_alba
stina_berg	stina_berg
hanna_hilton	hanna_hilton
cindy_margolis	cindy_margolis
elsie_wagstaff	elsie_wagstaff
ayumi_tsunematsu	ayumi_tsunematsu
ayako_shiraishi	ayako_shiraishi
saki_kagami	saki_kagami
marcus_mojo	marcus_mojo
gerald_case	gerald_case
nicholas_audsley	nicholas_audsley
fumie_kashiyama	fumie_kashiyama
asuka_tanii	asuka_tanii
jack_galloway	jack_galloway
declan_mulholland	declan_mulholland
william_chak	william_chak
ulla_skoog	ulla_skoog
charles_tilson-chowne	charles_tilson-chowne
melissa_ng	melissa_ng
shigeo_tokuda	shigeo_tokuda
shiro_kishibe	shiro_kishibe
barbara_schulz	barbara_schulz
lu_chen_(actress)	lu_chen_(actress)
eric_stryker	eric_stryker
maho_nonami	maho_nonami
rivers_cadet	rivers_cadet
miki_yeung	miki_yeung
jodie_moore	jodie_moore
wilson_yip	wilson_yip
stig_olin	stig_olin
barrett_blade	barrett_blade
veronica_hart	veronica_hart
lena_bergman	lena_bergman
wang_baoqiang	wang_baoqiang
michelle_bauer	michelle_bauer
caroline_cellier	caroline_cellier
tatum_reed	tatum_reed
kiyomi_asai	kiyomi_asai
mayumi_hidaka	mayumi_hidaka
skin_diamond	skin_diamond
wendy_whoppers	wendy_whoppers
hou_baolin	hou_baolin
kristal_tin	kristal_tin
jana_carpenter	jana_carpenter
philippa_urquhart	philippa_urquhart
meisa_hanai	meisa_hanai
gaspard_manesse	gaspard_manesse
umewaka_minoru_i	umewaka_minoru_i
angelita_helena_maria_de_silva_ferro	angelita_helena_maria_de_silva_ferro
noriko_hayami	noriko_hayami
ulf_eklund	ulf_eklund
yu_rongguang	yu_rongguang
tomohisa_yuge	tomohisa_yuge
tsai_yi-chen	tsai_yi-chen
emma_griffiths_malin	emma_griffiths_malin
naomi_tani	naomi_tani
adrianna_lynn	adrianna_lynn
henri_attal	henri_attal
claude_gensac	claude_gensac
ronald_cheng	ronald_cheng
betty_zhou	betty_zhou
susan_shaw	susan_shaw
astrid_chan	astrid_chan
yuki_matsunaga	yuki_matsunaga
jitsuko_yoshimura	jitsuko_yoshimura
ryosuke_kagawa	ryosuke_kagawa
angelica_sin	angelica_sin
tsubasa_otomiya	tsubasa_otomiya
adolphe_lemoine	adolphe_lemoine
ben_warriss	ben_warriss
motoko_sasaki	motoko_sasaki
joanna_kanska	joanna_kanska
alfred_hickman	alfred_hickman
james_wong_(lyricist)	james_wong_(lyricist)
misty_rain	misty_rain
samuel_kane	samuel_kane
pauline_peters	pauline_peters
shigeru_nakahara	shigeru_nakahara
keve_hjelm	keve_hjelm
amanda_hennessy	amanda_hennessy
penny_pax	penny_pax
langhorn_burton	langhorn_burton
diesel_washington	diesel_washington
jean_heywood	jean_heywood
alice_au	alice_au
kirsten_cooke	kirsten_cooke
georgia_fabish	georgia_fabish
madoka_ozawa	madoka_ozawa
leo_hallerstam	leo_hallerstam
james_bonn	james_bonn
kumiko_aso	kumiko_aso
misty_dawn	misty_dawn
tanveer_ghani	tanveer_ghani
wendy_van_der_plank	wendy_van_der_plank
jean_desailly	jean_desailly
mitsuomi_takahashi	mitsuomi_takahashi
stirling_gallacher	stirling_gallacher
charles_lamy	charles_lamy
adeline_hayden_coffin	adeline_hayden_coffin
maxine_gordon	maxine_gordon
amelia_bayntun	amelia_bayntun
deborah_makepeace	deborah_makepeace
maud_hyttenberg	maud_hyttenberg
tammi_ann	tammi_ann
richenda_carey	richenda_carey
lilian_braithwaite	lilian_braithwaite
fred_raynham	fred_raynham
marine_jahan	marine_jahan
cynthia_koh	cynthia_koh
david_keir	david_keir
jack_melford	jack_melford
harriet_philpin	harriet_philpin
marika_hayashi	marika_hayashi
shi_hui_(actor)	shi_hui_(actor)
megumi_tano	megumi_tano
satoko_yamano_(voice_actress)	satoko_yamano_(voice_actress)
emmanuelle_boidron	emmanuelle_boidron
liane_aukin	liane_aukin
miyako_yamaguchi	miyako_yamaguchi
eiko_koike	eiko_koike
charles_croker-king	charles_croker-king
skye_blue	skye_blue
jennifer_rhodes	jennifer_rhodes
tanroh_ishida	tanroh_ishida
jacques_debary	jacques_debary
chen_zhihui	chen_zhihui
alexis_tomassian	alexis_tomassian
lily_kann	lily_kann
nicola_cheung	nicola_cheung
miki_narahashi	miki_narahashi
zhang_yimou	zhang_yimou
sanji_hase	sanji_hase
air_force_amy	air_force_amy
takayuki_yamada	takayuki_yamada
brigitte_maier	brigitte_maier
andrew_seow	andrew_seow
andy_lau	andy_lau
ellen_parker_(actress)	ellen_parker_(actress)
theresa_fu	theresa_fu
mia_kihl	mia_kihl
masahiro_inoue	masahiro_inoue
fuko	fuko
ritsuko_nemoto	ritsuko_nemoto
jewel_de'nyle	jewel_de'nyle
john_nightingale_(actor)	john_nightingale_(actor)
nick_cheung	nick_cheung
anna-lisa_baude	anna-lisa_baude
karena_lam	karena_lam
jennifer_luv	jennifer_luv
barbara_yung	barbara_yung
max_mok	max_mok
benny_yau	benny_yau
jerrold_robertshaw	jerrold_robertshaw
iori_nomizu	iori_nomizu
john_hewer	john_hewer
mandy_wong	mandy_wong
cherrie_ying	cherrie_ying
mitsuki_tanimura	mitsuki_tanimura
mimi_nelson	mimi_nelson
wendy_morgan_(actress)	wendy_morgan_(actress)
jada_stevens	jada_stevens
marcelle_chantal	marcelle_chantal
david_buck	david_buck
chris_tranchell	chris_tranchell
jiang_wu	jiang_wu
gaynor_rowlands	gaynor_rowlands
morris_harvey	morris_harvey
claude_france	claude_france
ken_mitsuda	ken_mitsuda
zhang_yu_(actress)	zhang_yu_(actress)
koji_yamamoto_(actor)	koji_yamamoto_(actor)
tutta_rolf	tutta_rolf
nina_vanna	nina_vanna
rex_chandler	rex_chandler
takayuki_sakazume	takayuki_sakazume
eric_barclay	eric_barclay
erik_everhard	erik_everhard
eiji_takemoto	eiji_takemoto
jon_dough	jon_dough
paul_bazely	paul_bazely
john_baskcomb	john_baskcomb
felix_wong	felix_wong
adrian_hall_(actor)	adrian_hall_(actor)
sydnee_steele	sydnee_steele
birgitta_valberg	birgitta_valberg
gaynor_hodgson	gaynor_hodgson
arisa_komiya	arisa_komiya
david_caves	david_caves
pandora_clifford	pandora_clifford
yuri_shiratori	yuri_shiratori
chapman_to	chapman_to
rolf_skoglund	rolf_skoglund
maud_forget	maud_forget
arlette_poirier	arlette_poirier
james_greene_(actor)	james_greene_(actor)
marie-france_(actress)	marie-france_(actress)
zara_nutley	zara_nutley
ann_michelle	ann_michelle
jeffrey_perry_(british_actor)	jeffrey_perry_(british_actor)
lexi_belle	lexi_belle
helen_duval	helen_duval
jonathan_slinger	jonathan_slinger
minoru_shiraishi	minoru_shiraishi
lisa_lindgren	lisa_lindgren
flower_tucci	flower_tucci
reona_hirota	reona_hirota
shinsuke_ashida	shinsuke_ashida
deborah_grant	deborah_grant
moses_chan	moses_chan
moya_brady	moya_brady
ryota_ozawa	ryota_ozawa
brandon_wong_(actor)	brandon_wong_(actor)
bobby_au-yeung	bobby_au-yeung
kaylynn	kaylynn
chiharu_nakai	chiharu_nakai
vicki_chase	vicki_chase
jenna_presley	jenna_presley
kyousei_tsukui	kyousei_tsukui
marjorie_fielding	marjorie_fielding
sophie_barjac	sophie_barjac
roger_duchesne	roger_duchesne
pu_cunxin	pu_cunxin
jacqueline_boatswain	jacqueline_boatswain
misako_konno	misako_konno
r._j._danvers	r._j._danvers
kenji_ohba	kenji_ohba
leslie_graves	leslie_graves
rosamund_kwan	rosamund_kwan
satomi_kobayashi	satomi_kobayashi
terumi_niki	terumi_niki
edward_baker-duly	edward_baker-duly
hsie_he-hsian	hsie_he-hsian
peter_sproule	peter_sproule
noriko_nakagoshi	noriko_nakagoshi
gui_gui	gui_gui
vivian_hsu	vivian_hsu
will_theakston	will_theakston
wendy_williams_(pornographic_actress)	wendy_williams_(pornographic_actress)
zhu_xu	zhu_xu
roger_kemble	roger_kemble
gabrielle_daye	gabrielle_daye
bunny_bleu	bunny_bleu
paula_shaw	paula_shaw
jada_fire	jada_fire
michelle_thorne	michelle_thorne
kaori_shimizu_(voice_actress)	kaori_shimizu_(voice_actress)
mya_diamond	mya_diamond
abel_tarride	abel_tarride
yuki_ninagawa	yuki_ninagawa
desmond_tan	desmond_tan
jean-pierre_castaldi	jean-pierre_castaldi
fewlass_llewellyn	fewlass_llewellyn
peter_lindgren_(actor)	peter_lindgren_(actor)
alyssa_chia	alyssa_chia
keisha_kane	keisha_kane
veronica_avluv	veronica_avluv
anna_malle	anna_malle
britt_morgan	britt_morgan
kerry_louise	kerry_louise
sumiko_sakamoto	sumiko_sakamoto
jimmy_aubrey	jimmy_aubrey
alfred_wellesley	alfred_wellesley
chui_tien-you	chui_tien-you
hiroaki_murakami	hiroaki_murakami
ran_asakawa	ran_asakawa
pierre_maguelon	pierre_maguelon
don_fernando	don_fernando
philip_ng	philip_ng
belinda_hamnett	belinda_hamnett
sarah_shevon	sarah_shevon
yuiko_tatsumi	yuiko_tatsumi
ulf_larsson	ulf_larsson
mc_jin	mc_jin
arty_ash	arty_ash
lela_star	lela_star
han_geng	han_geng
erino_hazuki	erino_hazuki
georg_skarstedt	georg_skarstedt
lucien_guitry	lucien_guitry
michael_osborne_(actor)	michael_osborne_(actor)
lo_wei	lo_wei
zelah_clarke	zelah_clarke
lydia_shum	lydia_shum
flex-deon_blake	flex-deon_blake
lacy_rose	lacy_rose
ai_uchikawa	ai_uchikawa
akiko_kimura	akiko_kimura
zak_spears	zak_spears
amguulan	amguulan
sarah_quintrell	sarah_quintrell
ben_batt	ben_batt
mirai_shida	mirai_shida
saburo_ishikura	saburo_ishikura
serge_sauvion	serge_sauvion
saki_nakajima_(voice_actress)	saki_nakajima_(voice_actress)
anna_anka	anna_anka
georgie_harris	georgie_harris
leila_birch	leila_birch
syd_walker	syd_walker
bradford_thomas_wagner	bradford_thomas_wagner
yvonne_de_bray	yvonne_de_bray
hiromi_igarashi	hiromi_igarashi
masanari_nihei	masanari_nihei
kanako_fukaura	kanako_fukaura
narimi_arimori	narimi_arimori
alice_connor	alice_connor
jenny_platt	jenny_platt
kaori_shimamura	kaori_shimamura
nakamura_nakazo_i	nakamura_nakazo_i
mari_shirato	mari_shirato
michiyo_yanagisawa	michiyo_yanagisawa
jean_yonnel	jean_yonnel
yuen_wah	yuen_wah
rie_nakagawa	rie_nakagawa
shino_kakinuma	shino_kakinuma
sidney_vivian	sidney_vivian
eri_imai	eri_imai
ovidie	ovidie
akimitsu_takase	akimitsu_takase
liu_shishi	liu_shishi
sun_daolin	sun_daolin
peter_tilbury	peter_tilbury
birgit_tengroth	birgit_tengroth
fillie_lyckow	fillie_lyckow
colette_brettel	colette_brettel
wang_luoyong	wang_luoyong
cj_gibson	cj_gibson
kohji_moritsugu	kohji_moritsugu
bryony_hannah	bryony_hannah
kaho_minami	kaho_minami
noriko_ogawa_(singer)	noriko_ogawa_(singer)
judy_buxton	judy_buxton
ekin_cheng	ekin_cheng
denmei_suzuki	denmei_suzuki
fann_wong	fann_wong
jeremy_burnham	jeremy_burnham
alex_lam	alex_lam
john_glyn-jones	john_glyn-jones
kento_handa	kento_handa
julia_foster	julia_foster
rex_mcdougall	rex_mcdougall
annie_wu_(actress)	annie_wu_(actress)
vanness_wu	vanness_wu
michiko_kichise	michiko_kichise
avy_scott	avy_scott
george_kuwa	george_kuwa
ayano_niina	ayano_niina
martin_wyldeck	martin_wyldeck
oliver_boot	oliver_boot
tom_gill_(actor)	tom_gill_(actor)
rachel_ashley	rachel_ashley
ai_iijima	ai_iijima
kikko_matsuoka	kikko_matsuoka
nick_manning	nick_manning
guo_liang_(actor)	guo_liang_(actor)
edith_sharpe	edith_sharpe
rufus_(actor)	rufus_(actor)
colette_marchand	colette_marchand
hugh_clark_(actor)	hugh_clark_(actor)
guillaume_gouix	guillaume_gouix
nicky_ladanowski	nicky_ladanowski
anthony_hulme	anthony_hulme
mick_walter	mick_walter
chris_trenfield	chris_trenfield
carol_starks	carol_starks
tamao_nakamura	tamao_nakamura
mitsuru_karahashi	mitsuru_karahashi
eileen_moore	eileen_moore
colin_maitland	colin_maitland
kotono_shibuya	kotono_shibuya
john_marlborough_east	john_marlborough_east
richard_bird_(actor)	richard_bird_(actor)
henri_nassiet	henri_nassiet
jeanette_aw	jeanette_aw
katherine_locke	katherine_locke
anna_wilson-jones	anna_wilson-jones
ludde_gentzel	ludde_gentzel
rie_ishizuka	rie_ishizuka
maria_kawamura	maria_kawamura
janey_robbins	janey_robbins
li_bingbing	li_bingbing
katalin_vad	katalin_vad
frederick_culley	frederick_culley
patrick_connor_(actor)	patrick_connor_(actor)
louis_salou	louis_salou
bruce_venture	bruce_venture
fiona_lewis	fiona_lewis
suzana_alves	suzana_alves
duncan_mcrae_(actor)	duncan_mcrae_(actor)
johanna_hargreaves	johanna_hargreaves
james_anthony_pearson	james_anthony_pearson
choi_kwok-wai	choi_kwok-wai
kong_ngai	kong_ngai
claudia_claire	claudia_claire
alison_glennie	alison_glennie
lee_siu-kei	lee_siu-kei
hilda_spong	hilda_spong
alice_henley	alice_henley
dany_verissimo	dany_verissimo
jackie_chan_stunt_team	jackie_chan_stunt_team
helen_shingler	helen_shingler
megumi_urawa	megumi_urawa
julie_suedo	julie_suedo
ruby_wong	ruby_wong
henri_virlogeux	henri_virlogeux
jiang_xin	jiang_xin
shirley_kwan	shirley_kwan
helen_atkinson-wood	helen_atkinson-wood
chris_tong	chris_tong
ronald_hines	ronald_hines
kate_baines	kate_baines
katie_rolfsen	katie_rolfsen
laura_smet	laura_smet
suzy_prim	suzy_prim
everley_gregg	everley_gregg
jane_booker	jane_booker
eiichi_kikuchi	eiichi_kikuchi
ciara_janson	ciara_janson
karin_schubert	karin_schubert
bai_guang	bai_guang
miho_maeshima	miho_maeshima
terence_o'brien_(actor)	terence_o'brien_(actor)
tomoko_tabata	tomoko_tabata
leo_britt	leo_britt
stella_chung	stella_chung
femi_taylor	femi_taylor
chen_hanwei	chen_hanwei
hirokazu_hiramatsu	hirokazu_hiramatsu
barrie_gosney	barrie_gosney
christy_mack	christy_mack
megumi_kagurazaka	megumi_kagurazaka
simon_cook_(actor)	simon_cook_(actor)
jonathan_putra	jonathan_putra
ayumi_kida	ayumi_kida
miki_takahashi	miki_takahashi
a.e._coleby	a.e._coleby
john_ekman	john_ekman
sabrine_maui	sabrine_maui
kumiko_akiyoshi	kumiko_akiyoshi
kanon_kasuga	kanon_kasuga
john_voce	john_voce
steffan_rhodri	steffan_rhodri
teagan_presley	teagan_presley
stormy_daniels	stormy_daniels
holly_sampson	holly_sampson
angelica_bella	angelica_bella
rolf_leslie	rolf_leslie
rikard_wolff	rikard_wolff
miho_yamada	miho_yamada
ian_whyte_(actor)	ian_whyte_(actor)
douglas_fielding	douglas_fielding
jason_crew	jason_crew
jonathan_cohen_(actor)	jonathan_cohen_(actor)
chyna	chyna
christy_canyon	christy_canyon
mitsuaki_hoshino	mitsuaki_hoshino
ryohei_otani	ryohei_otani
jana_cova	jana_cova
brian_grellis	brian_grellis
julien_kang	julien_kang
michael_brandon_(pornographic_actor)	michael_brandon_(pornographic_actor)
yumiko_fujita	yumiko_fujita
inari_vachs	inari_vachs
ingvar_kjellson	ingvar_kjellson
anders_linder	anders_linder
stacy_valentine	stacy_valentine
joanna_monro	joanna_monro
janina_faye	janina_faye
helena_pickard	helena_pickard
iain_mitchell	iain_mitchell
maria_antonietta_beluzzi	maria_antonietta_beluzzi
pierre-ulric_dubuisson	pierre-ulric_dubuisson
eglantine_rembauville	eglantine_rembauville
george_bryan_(16th-century_actor)	george_bryan_(16th-century_actor)
adam_killian	adam_killian
stacy_burke	stacy_burke
youki_kudoh	youki_kudoh
estelle_desanges	estelle_desanges
taketoshi_naito	taketoshi_naito
jacques_gamblin	jacques_gamblin
stella_bonheur	stella_bonheur
evan_stone	evan_stone
wendy_divine	wendy_divine
sita_chan	sita_chan
cilla_kung	cilla_kung
sire_ma	sire_ma
mami_higashiyama	mami_higashiyama
makoto_furukawa	makoto_furukawa
mayumi_suzuki	mayumi_suzuki
eric_mason	eric_mason
phil_nice	phil_nice
sawa_ishige	sawa_ishige
david_michaels_(actor)	david_michaels_(actor)
edgar_driver	edgar_driver
hiroya_ishimaru	hiroya_ishimaru
moana_pozzi	moana_pozzi
yuan_muzhi	yuan_muzhi
pat_myne	pat_myne
annabelle_dowler	annabelle_dowler
bert_wynne	bert_wynne
renee_kelly	renee_kelly
minehiro_kinomoto	minehiro_kinomoto
jacques_fabbri	jacques_fabbri
phoebe_waller-bridge	phoebe_waller-bridge
morio_kazama	morio_kazama
jay_grdina	jay_grdina
david_niven,_jr.	david_niven,_jr.
victoria_woodward	victoria_woodward
jennifer_welles	jennifer_welles
mars_(actor)	mars_(actor)
fumi_dan	fumi_dan
xu_qing	xu_qing
arne_ragneborn	arne_ragneborn
gia_darling	gia_darling
ariel_lin	ariel_lin
beatrice_hsu	beatrice_hsu
reika_kirishima	reika_kirishima
lynne_miller	lynne_miller
pierre_vernier_(actor)	pierre_vernier_(actor)
wei_wei_(actress)	wei_wei_(actress)
figaro_tseng	figaro_tseng
ann_kok	ann_kok
kenichi_ono	kenichi_ono
andrew_lin	andrew_lin
denise_legeay	denise_legeay
fiona_mollison	fiona_mollison
ian_barritt	ian_barritt
yao_chen	yao_chen
lau_kong	lau_kong
robert_adair_(actor)	robert_adair_(actor)
alan_cooke	alan_cooke
eric_bransby_williams	eric_bransby_williams
kyoko_ayana	kyoko_ayana
holly_bodimeade	holly_bodimeade
marianne_denicourt	marianne_denicourt
akiji_kobayashi	akiji_kobayashi
hebe_tien	hebe_tien
wong_cho-lam	wong_cho-lam
tien_feng	tien_feng
kingdom_yuen	kingdom_yuen
ai_kurosawa	ai_kurosawa
brandy_alexandre	brandy_alexandre
lucy_russell_(actress)	lucy_russell_(actress)
george_silver_(actor)	george_silver_(actor)
monica_mayhem	monica_mayhem
denise_grey	denise_grey
adam_chen	adam_chen
eric_richard	eric_richard
geoffrey_sumner	geoffrey_sumner
julia_lockwood	julia_lockwood
ryo_hayami	ryo_hayami
louise_harrison	louise_harrison
dora_de_winton	dora_de_winton
samantha_ryan	samantha_ryan
brooke_skye	brooke_skye
alfred_paget	alfred_paget
ayame_ikehata	ayame_ikehata
katsuyuki_murai	katsuyuki_murai
james_stephenson	james_stephenson
liu_yuxin	liu_yuxin
shizuma_hodoshima	shizuma_hodoshima
mai_hirano	mai_hirano
michelle_chong	michelle_chong
natsumi_yanase	natsumi_yanase
barbro_kollberg	barbro_kollberg
nikki_charm	nikki_charm
eugene_simon	eugene_simon
jim_howick	jim_howick
victor_brooks	victor_brooks
patrick_collins_(director)	patrick_collins_(director)
kerrie_taylor	kerrie_taylor
mark_wakeling	mark_wakeling
gladys_jennings	gladys_jennings
barbara_durkin	barbara_durkin
sharon_mitchell	sharon_mitchell
maxime_leroux	maxime_leroux
jessica_hall_(british_actress)	jessica_hall_(british_actress)
vince_rockland	vince_rockland
christian_vadim	christian_vadim
george_innes	george_innes
ty_fox	ty_fox
gudrun_brost	gudrun_brost
annette_haven	annette_haven
misako_tanaka	misako_tanaka
fala_chen	fala_chen
hitomi_shiraishi	hitomi_shiraishi
raoul_billerey	raoul_billerey
kayoko_shibata	kayoko_shibata
holly_kaneko	holly_kaneko
fan_wei	fan_wei
fritha_goodey	fritha_goodey
alexis_amore	alexis_amore
john_light_(actor)	john_light_(actor)
sarah_jane_hamilton	sarah_jane_hamilton
yayoi_jinguji	yayoi_jinguji
scott_tanner	scott_tanner
jonathan_wong_chee-hynn	jonathan_wong_chee-hynn
alex_fong_(actor)	alex_fong_(actor)
lin_meijiao	lin_meijiao
mitsuhiro_ichiki	mitsuhiro_ichiki
charmaine_sinclair	charmaine_sinclair
tony_marshall_(actor)	tony_marshall_(actor)
jan_erik_lindqvist	jan_erik_lindqvist
a.e._george	a.e._george
yngve_gamlin	yngve_gamlin
mahiru_konno	mahiru_konno
danni_ashe	danni_ashe
lacy_ryan	lacy_ryan
coral_atkins	coral_atkins
mona_dol	mona_dol
toni_edgar-bruce	toni_edgar-bruce
jennifer_ketcham	jennifer_ketcham
atsushi_kisaichi	atsushi_kisaichi
mike_john	mike_john
ai_maeda_(voice_actress)	ai_maeda_(voice_actress)
gwynne_herbert	gwynne_herbert
paul_ritter_(actor)	paul_ritter_(actor)
jack_hobbs_(actor)	jack_hobbs_(actor)
emi_nitta	emi_nitta
meggan_mallone	meggan_mallone
ashli_orion	ashli_orion
lin_xiawei	lin_xiawei
oliver_biles	oliver_biles
yao_wenlong	yao_wenlong
barbara_laage	barbara_laage
jenny_tseng	jenny_tseng
pamelyn_chee	pamelyn_chee
zeb_atlas	zeb_atlas
hiroko_takemasa	hiroko_takemasa
ben_aldridge_(actor)	ben_aldridge_(actor)
julian_cheung	julian_cheung
mugambwa_sseruwagi	mugambwa_sseruwagi
carmen_hart	carmen_hart
david_raven_(actor)	david_raven_(actor)
sonia_baby	sonia_baby
takayuki_tsubaki	takayuki_tsubaki
ian_kelsey	ian_kelsey
viviane_ventura	viviane_ventura
patrick_guillemin	patrick_guillemin
eisuke_asakura	eisuke_asakura
anand_rajaram	anand_rajaram
neil_fitzwiliam	neil_fitzwiliam
isis_taylor	isis_taylor
emily_woof	emily_woof
collin_chou	collin_chou
angelo_marconi	angelo_marconi
roger_karl	roger_karl
william_allen_(actor)	william_allen_(actor)
katja_k	katja_k
hay_plumb	hay_plumb
holly_one	holly_one
masami_suzuki	masami_suzuki
nigel_barrie	nigel_barrie
berg_ng	berg_ng
bertha_belmore	bertha_belmore
xu_fan	xu_fan
jack_trevor	jack_trevor
dane_cross	dane_cross
toshiyuki_hosokawa	toshiyuki_hosokawa
shannon_lee	shannon_lee
nathalie_matti	nathalie_matti
joe_ma_(actor)	joe_ma_(actor)
tanya_hansen	tanya_hansen
hiroko_taguchi	hiroko_taguchi
josie_ho	josie_ho
masahiro_usui	masahiro_usui
alice_barry	alice_barry
kuranosuke_sasaki	kuranosuke_sasaki
martin_lewis_(english_actor)	martin_lewis_(english_actor)
sola_aoi	sola_aoi
michael_thomas_(actor)	michael_thomas_(actor)
bernice_liu	bernice_liu
lisa_palfrey	lisa_palfrey
lewis_lempereur-palmer	lewis_lempereur-palmer
lex_shrapnel	lex_shrapnel
yuki_sato_(actor)	yuki_sato_(actor)
patrick_tse	patrick_tse
lisa_sparks	lisa_sparks
mami_yamasaki	mami_yamasaki
seymore_butts	seymore_butts
wakin_chau	wakin_chau
manora_thew	manora_thew
chinami_nishimura	chinami_nishimura
lawrence_elion	lawrence_elion
ernest_hare	ernest_hare
lou_charmelle	lou_charmelle
tiana_lynn	tiana_lynn
joyce_kirby	joyce_kirby
yoko_shimada	yoko_shimada
yasuko_sawaguchi	yasuko_sawaguchi
shiho_hisajima	shiho_hisajima
jaime_chik	jaime_chik
jelena_jensen	jelena_jensen
tavalia_griffin	tavalia_griffin
yukimasa_kishino	yukimasa_kishino
minori_matsushima	minori_matsushima
van_fan	van_fan
annabel_chong	annabel_chong
yumika_hayashi	yumika_hayashi
jack_wu	jack_wu
song_dandan	song_dandan
birger_malmsten	birger_malmsten
douglas_seale	douglas_seale
sayaka_kinoshita	sayaka_kinoshita
rikiya_otaka	rikiya_otaka
judd_green	judd_green
yasmin_lee	yasmin_lee
jim_dunk	jim_dunk
lu_yi_(actor)	lu_yi_(actor)
rei_sakuma	rei_sakuma
junko_hagimori	junko_hagimori
barbro_flodquist	barbro_flodquist
mary_forbes	mary_forbes
jonathan_newth	jonathan_newth
leon_quartermaine	leon_quartermaine
eric_kot	eric_kot
roy_byford	roy_byford
edward_peel	edward_peel
keri_sable	keri_sable
charles_berling	charles_berling
dorinea_shirley	dorinea_shirley
yvonne_lombard	yvonne_lombard
florence_tan	florence_tan
tin_kai-man	tin_kai-man
sture_lagerwall	sture_lagerwall
jenteal	jenteal
kaoru_yachigusa	kaoru_yachigusa
yuri_mitsui	yuri_mitsui
asahi_kurizuka	asahi_kurizuka
vanessa_del_rio	vanessa_del_rio
elizabeth_berrington	elizabeth_berrington
yukiko_okamoto	yukiko_okamoto
walter_randall	walter_randall
paulette_noizeux	paulette_noizeux
simon_norrthon	simon_norrthon
mary_hon	mary_hon
kanji_tsuda	kanji_tsuda
james_tien_(actor)	james_tien_(actor)
drusilla_wills	drusilla_wills
mark_kingston	mark_kingston
norma_west	norma_west
robert_le_vigan	robert_le_vigan
nanako_matsushima	nanako_matsushima
ken_yamauchi	ken_yamauchi
joe_shaw_(actor)	joe_shaw_(actor)
jeannie_chan	jeannie_chan
claudine_beccarie	claudine_beccarie
richie_jen	richie_jen
jacques_toja	jacques_toja
madoka_kimura	madoka_kimura
taishi_murata	taishi_murata
hirotaka_chiba	hirotaka_chiba
asahi_uchida	asahi_uchida
jia_nailiang	jia_nailiang
natsuki_okamoto	natsuki_okamoto
yuriko_yamaguchi_(voice_actress)	yuriko_yamaguchi_(voice_actress)
mayu_nozomi	mayu_nozomi
koichi_iwaki	koichi_iwaki
minako_sango	minako_sango
maria_lundqvist	maria_lundqvist
wallace_geoffrey	wallace_geoffrey
daniel_chan	daniel_chan
ai_kobayashi	ai_kobayashi
jean_martinelli	jean_martinelli
nobuo_nakamura	nobuo_nakamura
russell_cheung	russell_cheung
margaret_lacey	margaret_lacey
ellen_chan	ellen_chan
yang_li-hua	yang_li-hua
marc_wallice	marc_wallice
yuriko_yamamoto	yuriko_yamamoto
eileen_helsby	eileen_helsby
koen_kondo	koen_kondo
wu_yingyin	wu_yingyin
paul_sorensen	paul_sorensen
elliot_levey	elliot_levey
ikuo_nishikawa	ikuo_nishikawa
brigitte_lahaie	brigitte_lahaie
ema_kogure	ema_kogure
mohamed_said_(actor)	mohamed_said_(actor)
shigeru_shibuya	shigeru_shibuya
herbert_lomas_(actor)	herbert_lomas_(actor)
yoshino_kimura	yoshino_kimura
tom_hatton_(actor)	tom_hatton_(actor)
hiroyuki_nagato	hiroyuki_nagato
akari_hibino	akari_hibino
liao_fan	liao_fan
honoka	honoka
chikayo_nakano	chikayo_nakano
natalis_chan	natalis_chan
roberta_gemma	roberta_gemma
yvette_bova	yvette_bova
kaori_asoh	kaori_asoh
brad_patton	brad_patton
kwok_fung	kwok_fung
lymari_nadal	lymari_nadal
masachika_ichimura	masachika_ichimura
david_ross_(actor)	david_ross_(actor)
nora_miao	nora_miao
raymond_hermantier	raymond_hermantier
elanne_kong	elanne_kong
minoru_chiaki	minoru_chiaki
ken_takeuchi	ken_takeuchi
wang_xiaotang	wang_xiaotang
shinpachi_tsuji	shinpachi_tsuji
tomohiro_kaku	tomohiro_kaku
max_maxudian	max_maxudian
joan_kemp-welch	joan_kemp-welch
frederick_oxby	frederick_oxby
zhang_yuqi	zhang_yuqi
maria_kekkonen	maria_kekkonen
cayenne_klein	cayenne_klein
joshua_herdman	joshua_herdman
greta_vaillant	greta_vaillant
tiffany_leong	tiffany_leong
ashton_chen	ashton_chen
keiko_yokozawa	keiko_yokozawa
athena_chu	athena_chu
clive_graham	clive_graham
hung_yan-yan	hung_yan-yan
suzy_vernon	suzy_vernon
maki_sakai	maki_sakai
nahoko_kinoshita	nahoko_kinoshita
mandy_bright	mandy_bright
edward_burnham	edward_burnham
luisa_bradshaw-white	luisa_bradshaw-white
vaniity	vaniity
chisato_nakajima	chisato_nakajima
lin_feng-jiao	lin_feng-jiao
catherine_sutherland	catherine_sutherland
chen_xiuhuan	chen_xiuhuan
gigi_lai	gigi_lai
joel_chan_(actor)	joel_chan_(actor)
rufus_wright	rufus_wright
clement_mccallin	clement_mccallin
shinobu_nakayama	shinobu_nakayama
zhou_dongyu	zhou_dongyu
ina_clare	ina_clare
jarl_kulle	jarl_kulle
norm_grabowski	norm_grabowski
ulf_brunnberg	ulf_brunnberg
reuben_sallmander	reuben_sallmander
dorothy_bramhall	dorothy_bramhall
richard_lund	richard_lund
marie_luv	marie_luv
chen_tianwen	chen_tianwen
amanda_ooms	amanda_ooms
ryan_idol	ryan_idol
rika_komatsu	rika_komatsu
ashlynn_brooke	ashlynn_brooke
marilyn_jess	marilyn_jess
kie_nakai	kie_nakai
kumi_sakuma	kumi_sakuma
penelope_dudley-ward	penelope_dudley-ward
trisha_uptown	trisha_uptown
david_gwillim	david_gwillim
john_chaffey	john_chaffey
anna_nakagawa	anna_nakagawa
neil_bourguiba	neil_bourguiba
rosie_day	rosie_day
jun_kusanagi	jun_kusanagi
pascal_mazzotti	pascal_mazzotti
betty_lawford	betty_lawford
katsumi_tezuka	katsumi_tezuka
ellen_chaplin	ellen_chaplin
james_garbutt	james_garbutt
takahiro_yoshimizu	takahiro_yoshimizu
monica_mattos	monica_mattos
shyla_jennings	shyla_jennings
tetsuya_iwanaga	tetsuya_iwanaga
joanna_storm	joanna_storm
rafael_edholm	rafael_edholm
jeanne_mockford	jeanne_mockford
phil_mealey	phil_mealey
akira_otaka	akira_otaka
shiga_lin	shiga_lin
isako_washio	isako_washio
belinda_sinclair	belinda_sinclair
yuki_yamada	yuki_yamada
yan_bingliang	yan_bingliang
lau_kar-leung	lau_kar-leung
kate_asabuki	kate_asabuki
eri_kikuchi	eri_kikuchi
alexsander_freitas	alexsander_freitas
jonni_darkko	jonni_darkko
maurice_garrel	maurice_garrel
atsuki_tani	atsuki_tani
anna_konstam	anna_konstam
elizabeth_knepp	elizabeth_knepp
ariel_rebel	ariel_rebel
shawn_yue	shawn_yue
derek_mio	derek_mio
june_bland	june_bland
nikita_ramsey	nikita_ramsey
wade_nichols	wade_nichols
annette_schwarz	annette_schwarz
wilfred_lau	wilfred_lau
edward_jewesbury	edward_jewesbury
simon_robson	simon_robson
max_brimmell	max_brimmell
delaval_astley,_23rd_baron_hastings	delaval_astley,_23rd_baron_hastings
rio_matsumoto	rio_matsumoto
alex_jordan	alex_jordan
hiroko_sakurai	hiroko_sakurai
bobby_blake	bobby_blake
olivia_saint	olivia_saint
c.j._wright	c.j._wright
ah_niu	ah_niu
gladys_henson	gladys_henson
moa_arimoto	moa_arimoto
fubuki_takane	fubuki_takane
jack_ellis_(actor)	jack_ellis_(actor)
candy_lo	candy_lo
stephen_tate	stephen_tate
yukiko_kashiwagi	yukiko_kashiwagi
miki_sakai	miki_sakai
keith_drinkel	keith_drinkel
miwako_ichikawa	miwako_ichikawa
takeo_chii	takeo_chii
arthur_lane_(actor)	arthur_lane_(actor)
folke_sundquist	folke_sundquist
chiara_mastroianni	chiara_mastroianni
ariana_jollee	ariana_jollee
linsey_dawn_mckenzie	linsey_dawn_mckenzie
melanie_hudson	melanie_hudson
shingo_yamashiro	shingo_yamashiro
chieko_shiratori	chieko_shiratori
titof	titof
tolga_safer	tolga_safer
helen_kurup	helen_kurup
chloe_howman	chloe_howman
lena_granhagen	lena_granhagen
fu_biao	fu_biao
yao_yao	yao_yao
yumiko_kobayashi	yumiko_kobayashi
rena_murakami	rena_murakami
shin_saburi	shin_saburi
johan_widerberg	johan_widerberg
desmond_jeans	desmond_jeans
oma_ichimura	oma_ichimura
brigitte_kahn	brigitte_kahn
aarif_rahman	aarif_rahman
bridgette_monet	bridgette_monet
tom_chatto	tom_chatto
bengt_eklund	bengt_eklund
sayaka_kobayashi	sayaka_kobayashi
anna_blomberg	anna_blomberg
lesley_osmond	lesley_osmond
akane_omae	akane_omae
pierre_lindstedt	pierre_lindstedt
parineeti_chopra	parineeti_chopra
michael_redfern	michael_redfern
julia_channel	julia_channel
tova_magnusson	tova_magnusson
josh_brown_(actor)	josh_brown_(actor)
gordon_hopkirk	gordon_hopkirk
tsui_wing	tsui_wing
fylgia_zadig	fylgia_zadig
ken_shimizu	ken_shimizu
ya_chang	ya_chang
thomas_henty	thomas_henty
tomoyuki_dan	tomoyuki_dan
takatoshi_kaneko	takatoshi_kaneko
jackie_chan	jackie_chan
robin_irvine	robin_irvine
nikki_benz	nikki_benz
stig_lasseby	stig_lasseby
margit_carlqvist	margit_carlqvist
patricia_mok	patricia_mok
katie_gold	katie_gold
jeff_wang	jeff_wang
ralph_riach	ralph_riach
richard_pacheco	richard_pacheco
tae_okajima	tae_okajima
flora_chan	flora_chan
byron_long	byron_long
yvonne_yung	yvonne_yung
fred_goodwins	fred_goodwins
ivy_lee_(actress)	ivy_lee_(actress)
hiroshi_miyauchi	hiroshi_miyauchi
yura_hinata	yura_hinata
priscelia_chan	priscelia_chan
siw_hughes	siw_hughes
you_(actress)	you_(actress)
michael_tse	michael_tse
emi_kobayashi	emi_kobayashi
jason_hsu	jason_hsu
bethany_benz	bethany_benz
masami_kikuchi	masami_kikuchi
robert_shatterell	robert_shatterell
freddie_boath	freddie_boath
hitomi_kudo	hitomi_kudo
saori_ono	saori_ono
shigeru_mogi	shigeru_mogi
mary_meade	mary_meade
ruriko_asaoka	ruriko_asaoka
helena_gloag	helena_gloag
sei_hiraizumi	sei_hiraizumi
charles_dullin	charles_dullin
paul_hardwick	paul_hardwick
tori_black	tori_black
susan_skipper	susan_skipper
jessica_hsuan	jessica_hsuan
cathy_barry	cathy_barry
roxanne_blaze	roxanne_blaze
belita	belita
bobby_vitale	bobby_vitale
kazumi_tanaka	kazumi_tanaka
dave_cummings	dave_cummings
clare_thomas	clare_thomas
van_darkholme	van_darkholme
masaki_suda	masaki_suda
nina_zanjani	nina_zanjani
vic_polizos	vic_polizos
jade-blue_eclipse	jade-blue_eclipse
ron_hightower	ron_hightower
kaho_(actress)	kaho_(actress)
yoshimitsu_shimoyama	yoshimitsu_shimoyama
gregory_monro	gregory_monro
maud_yates	maud_yates
madge_stuart	madge_stuart
yasmine_lafitte	yasmine_lafitte
tomo_sakurai	tomo_sakurai
dave_o'toole	dave_o'toole
nicky_wu	nicky_wu
clare_clifford	clare_clifford
leah_luv	leah_luv
lu_yi-ching	lu_yi-ching
gary_hailes	gary_hailes
sayoko_yamaguchi	sayoko_yamaguchi
hideyuki_umezu	hideyuki_umezu
michael_irving	michael_irving
p._j._sparxx	p._j._sparxx
hiroshi_tachi	hiroshi_tachi
li_nanxing	li_nanxing
joan_morgan	joan_morgan
roy_travers	roy_travers
jake_steed	jake_steed
tom_kempinski	tom_kempinski
kristina_adolphson	kristina_adolphson
mary_rorke	mary_rorke
kokomi_sakura	kokomi_sakura
mimi_miyagi	mimi_miyagi
nikki_delano	nikki_delano
brigitte_lin	brigitte_lin
satomi_oka	satomi_oka
justin_brady	justin_brady
karlie_simon	karlie_simon
george_relph	george_relph
asuka_sakamaki	asuka_sakamaki
tericka_dye	tericka_dye
kevin_howarth	kevin_howarth
barbara_doll	barbara_doll
shu_chang_(actress)	shu_chang_(actress)
hu_xia	hu_xia
chen_shucheng	chen_shucheng
teruyuki_kagawa	teruyuki_kagawa
wiktor_andersson	wiktor_andersson
miho_nikaido	miho_nikaido
yukari_mizuno	yukari_mizuno
jacques_seiler	jacques_seiler
christian_barbier	christian_barbier
takayasu_usui	takayasu_usui
megumi_matsumoto	megumi_matsumoto
chris_charming	chris_charming
sunset_thomas	sunset_thomas
richard_cole_(actor)	richard_cole_(actor)
chie_sawaguchi	chie_sawaguchi
tony_leung_ka-fai	tony_leung_ka-fai
lisa_jackson_(actress)	lisa_jackson_(actress)
eric_wan	eric_wan
john_rolfe_(actor)	john_rolfe_(actor)
miki_sawaguchi	miki_sawaguchi
fred_emney	fred_emney
julian_hee	julian_hee
gertrude_sterroll	gertrude_sterroll
sayori_ishizuka	sayori_ishizuka
jane_sherwin	jane_sherwin
ernie_lotinga	ernie_lotinga
tracy_lee_(actress)	tracy_lee_(actress)
hideko_yoshida	hideko_yoshida
ivy_ling_po	ivy_ling_po
shane_diesel	shane_diesel
alexis_conran	alexis_conran
stanley_cheung	stanley_cheung
tamotsu_nishiwaki	tamotsu_nishiwaki
flora_finch	flora_finch
ryutarou_akimoto	ryutarou_akimoto
helen_blatch	helen_blatch
hubert_saint-macary	hubert_saint-macary
sam_bernard	sam_bernard
dana_vespoli	dana_vespoli
mariko_morikawa	mariko_morikawa
masato_hagiwara	masato_hagiwara
colin_campbell_(actor)	colin_campbell_(actor)
svea_holst	svea_holst
debi_sue_voorhees	debi_sue_voorhees
hayley_j_williams	hayley_j_williams
amelia_shankley	amelia_shankley
akira_watase	akira_watase
helena_barlow	helena_barlow
bowie_wu	bowie_wu
queenie_chu	queenie_chu
jon_glover	jon_glover
mary_stockley	mary_stockley
jiang_wen	jiang_wen
zhu_lin_(actress)	zhu_lin_(actress)
eileen_percy	eileen_percy
liza_wang	liza_wang
chanel_preston	chanel_preston
kika_mirylees	kika_mirylees
chris_larkin	chris_larkin
keiko_suzuka	keiko_suzuka
josette_simon	josette_simon
philippe_volter	philippe_volter
elly_akira	elly_akira
elena_berkova	elena_berkova
james_gilbey	james_gilbey
chloe_jones	chloe_jones
rui_sakuragi	rui_sakuragi
michel_nastorg	michel_nastorg
hiroko_emori	hiroko_emori
mako_(voice_actress)	mako_(voice_actress)
lauren_brice	lauren_brice
graham_roberts_(actor)	graham_roberts_(actor)
michael_martin_harvey	michael_martin_harvey
taylor_rain	taylor_rain
stanley_huang	stanley_huang
takumi_yamazaki	takumi_yamazaki
mayu_tsuruta	mayu_tsuruta
fuyukichi_maki	fuyukichi_maki
keiko_suzuki	keiko_suzuki
elin_klinga	elin_klinga
kristina_wayborn	kristina_wayborn
kenny_bee	kenny_bee
marie_robertson	marie_robertson
teresa_gallagher	teresa_gallagher
kelda_holmes	kelda_holmes
takayuki_inoue	takayuki_inoue
rio_hamasaki	rio_hamasaki
haruna_yabuki	haruna_yabuki
barbara_kinghorn	barbara_kinghorn
garance_le_guillermic	garance_le_guillermic
julian_firth	julian_firth
dorothy_lemay	dorothy_lemay
anita_lindblom	anita_lindblom
ni_ni	ni_ni
stig_johanson	stig_johanson
sachiko_katsumata	sachiko_katsumata
nina_fry	nina_fry
masaki_okada	masaki_okada
ron_jeremy	ron_jeremy
lillian_logan	lillian_logan
katsuo_nakamura	katsuo_nakamura
juli_ashton	juli_ashton
ako_(actress)	ako_(actress)
bobbi_starr	bobbi_starr
tiffany_million	tiffany_million
felicia_fox	felicia_fox
kimie_shingyoji	kimie_shingyoji
john_hollis	john_hollis
edna_davies	edna_davies
yuan_shuai_(actor)	yuan_shuai_(actor)
hugh_sachs	hugh_sachs
sasha_gabor	sasha_gabor
antonio_resines	antonio_resines
lucy_robinson_(actress)	lucy_robinson_(actress)
akiko_wakabayashi	akiko_wakabayashi
hiroshi_tsuburaya	hiroshi_tsuburaya
rosalind_bailey	rosalind_bailey
rocco_siffredi	rocco_siffredi
anna_lindahl	anna_lindahl
angela_grant	angela_grant
isabel_ice	isabel_ice
roy_chiu	roy_chiu
aylar_lie	aylar_lie
yukio_yamagata	yukio_yamagata
anthony_rosano	anthony_rosano
hideo_murota	hideo_murota
yvonne_owen	yvonne_owen
frank_tennant	frank_tennant
dolly_buster	dolly_buster
nils_poppe	nils_poppe
aurore_auteuil	aurore_auteuil
bionca	bionca
luc_andrieux	luc_andrieux
rod_barry	rod_barry
angelique_morgan	angelique_morgan
lexington_steele	lexington_steele
alan_tern	alan_tern
yutaka_takenouchi	yutaka_takenouchi
rebeca_linares	rebeca_linares
remy_lacroix	remy_lacroix
bret_wolfe	bret_wolfe
akiko_nakagawa	akiko_nakagawa
crystal_knight	crystal_knight
toku_nishio	toku_nishio
kazue_ikura	kazue_ikura
manpei_takagi	manpei_takagi
constance_money	constance_money
masahiko_tanaka	masahiko_tanaka
kenji_roa	kenji_roa
nozomi_masu	nozomi_masu
yukari_nozawa	yukari_nozawa
jennifer_stewart	jennifer_stewart
joan_maude	joan_maude
michiyo_aratama	michiyo_aratama
miki_inoue	miki_inoue
keiran_lee	keiran_lee
masato_hirano_(voice_actor)	masato_hirano_(voice_actor)
vivienne_chatterton	vivienne_chatterton
eva_vortex	eva_vortex
joan_ritz	joan_ritz
kei_yamamoto	kei_yamamoto
ken_mizorogi	ken_mizorogi
norman_page	norman_page
show_luo	show_luo
hubert_deschamps	hubert_deschamps
marco_banderas	marco_banderas
nick_conway	nick_conway
mark_spalding	mark_spalding
herschel_savage	herschel_savage
denyse_alexander	denyse_alexander
suzy_mandel	suzy_mandel
jean-pierre_darras	jean-pierre_darras
erik_strandmark	erik_strandmark
simone_hyams	simone_hyams
krista_lane	krista_lane
giani_esposito	giani_esposito
donna_edwards_(actress)	donna_edwards_(actress)
dan_cunningham	dan_cunningham
mutsumi_fukuma	mutsumi_fukuma
philip_bowen	philip_bowen
signe_wirff	signe_wirff
derek_deadman	derek_deadman
risa_hayamizu	risa_hayamizu
jing_tian	jing_tian
erik_rhodes_(pornographic_actor)	erik_rhodes_(pornographic_actor)
yoshie_taira	yoshie_taira
rebecca_brooke	rebecca_brooke
tsui_hark	tsui_hark
lars_green	lars_green
louis_fan	louis_fan
freddie_cunliffe	freddie_cunliffe
adam_cheng	adam_cheng
wu_yue_(actor)	wu_yue_(actor)
evan_seinfeld	evan_seinfeld
qian_zhijun	qian_zhijun
alexandra_silk	alexandra_silk
joe_cheung	joe_cheung
kaoru_mizuki	kaoru_mizuki
julie-marie_parmentier	julie-marie_parmentier
chise_nakamura	chise_nakamura
joe_chen	joe_chen
eileen_magrath	eileen_magrath
inger_nilsson	inger_nilsson
wang_yuqing	wang_yuqing
juliana_donald	juliana_donald
kozue_yoshizumi	kozue_yoshizumi
taro_yamaguchi	taro_yamaguchi
wang_lung-wei	wang_lung-wei
nanaho_katsuragi	nanaho_katsuragi
maggie_shiu	maggie_shiu
sophie_dee	sophie_dee
trevor_martin	trevor_martin
alec_su	alec_su
jack_mckenzie_(actor)	jack_mckenzie_(actor)
majandra_delfino	majandra_delfino
henrietta_watson	henrietta_watson
susanna_kwan	susanna_kwan
veronica_carlson	veronica_carlson
cecil_humphreys	cecil_humphreys
megumi_seki	megumi_seki
queenie_thomas	queenie_thomas
pauline_chan_bo-lin	pauline_chan_bo-lin
toshiko_fujita	toshiko_fujita
osamu_takizawa	osamu_takizawa
monster_maezuka	monster_maezuka
stephen_billington	stephen_billington
philip_middlemiss	philip_middlemiss
katrin_sundberg	katrin_sundberg
chris_jury	chris_jury
alec_sabin	alec_sabin
kan_tanaka	kan_tanaka
sunny_chan	sunny_chan
davina_craig	davina_craig
power_chan	power_chan
geoffrey_freshwater	geoffrey_freshwater
tsutomu_yamazaki	tsutomu_yamazaki
kate_hardie	kate_hardie
dagny_lind	dagny_lind
cara_fawn	cara_fawn
william_marlowe	william_marlowe
gallen_lo	gallen_lo
adam_rayner	adam_rayner
kaori_yamagata	kaori_yamagata
masaaki_tsukada	masaaki_tsukada
ricky_martinez	ricky_martinez
booth_conway	booth_conway
dulice_liecier	dulice_liecier
jenny_alpha	jenny_alpha
lewis_dayton	lewis_dayton
grace_chang	grace_chang
richard_low	richard_low
strelsa_brown	strelsa_brown
stefan_sauk	stefan_sauk
michel_constantin	michel_constantin
ayaka_wilson	ayaka_wilson
toivo_pawlo	toivo_pawlo
yngve_nordwall	yngve_nordwall
michael-joel_david_stuart	michael-joel_david_stuart
tomo_saeki	tomo_saeki
tanya_tate	tanya_tate
nao_saejima	nao_saejima
mary_germaine	mary_germaine
janet_jacme	janet_jacme
frances_white	frances_white
inga_brooksby	inga_brooksby
blake_riley	blake_riley
reina_leone	reina_leone
patricia_brake	patricia_brake
joanna_hole	joanna_hole
jack_neo	jack_neo
sabrina_ouazani	sabrina_ouazani
harry_agar_lyons	harry_agar_lyons
misaki_sekiyama	misaki_sekiyama
bunny_luv	bunny_luv
takashi_onozuka	takashi_onozuka
michael_graham_cox	michael_graham_cox
frank_towers	frank_towers
simon_rivers	simon_rivers
sharka_blue	sharka_blue
billy_boyle	billy_boyle
vin_choi	vin_choi
mandy_chiang	mandy_chiang
chris_perry-metcalf	chris_perry-metcalf
kim_hartman	kim_hartman
jordan_routledge	jordan_routledge
jeremy_spenser	jeremy_spenser
irene_lindh	irene_lindh
taylor_vixen	taylor_vixen
blue_washington	blue_washington
keiko_toda	keiko_toda
tim_von_swine	tim_von_swine
betty_ann_davies	betty_ann_davies
christian_brassington	christian_brassington
calvin_chen	calvin_chen
william_gaminara	william_gaminara
albert_valentine_(actor)	albert_valentine_(actor)
letha_weapons	letha_weapons
ryo_kase	ryo_kase
cordelia_bugeja	cordelia_bugeja
pihla_viitala	pihla_viitala
lene_lai	lene_lai
angell_summers	angell_summers
amy_yamazaki	amy_yamazaki
frank_birch	frank_birch
mary_kerridge	mary_kerridge
mary_jean_reimer	mary_jean_reimer
kelly_nichols	kelly_nichols
madeleine_robinson	madeleine_robinson
steve_drake	steve_drake
song_wenfei	song_wenfei
india_summer	india_summer
mark_greenstreet	mark_greenstreet
christie_stevens	christie_stevens
kwan_hoi-san	kwan_hoi-san
ambrosine_phillpotts	ambrosine_phillpotts
andy_san_dimas	andy_san_dimas
scott_nails	scott_nails
tom_riley_(actor)	tom_riley_(actor)
jean_davy	jean_davy
bak_sheut-sin	bak_sheut-sin
gillian_blake	gillian_blake
yurika_hino	yurika_hino
gaston_jacquet	gaston_jacquet
dave_carter_(actor)	dave_carter_(actor)
lisa_bowerman	lisa_bowerman
akiko_kobayashi_(voice_actor)	akiko_kobayashi_(voice_actor)
rin_takanashi	rin_takanashi
diamond_foxxx	diamond_foxxx
thierry_fortineau	thierry_fortineau
tom_macaulay	tom_macaulay
john_grillo	john_grillo
daniel_chatto	daniel_chatto
toshiaki_karasawa	toshiaki_karasawa
christine_ng	christine_ng
weiron_holmberg	weiron_holmberg
samantha_saint	samantha_saint
ian_aspinall	ian_aspinall
billy_brandt	billy_brandt
christi_lake	christi_lake
kumiko_takizawa	kumiko_takizawa
arlene_rothlein	arlene_rothlein
tomoko_hoshino	tomoko_hoshino
violet_graham	violet_graham
hu_die	hu_die
stuart_burge	stuart_burge
eileen_essell	eileen_essell
pearce_quigley	pearce_quigley
yoko_moriguchi	yoko_moriguchi
idy_chan	idy_chan
keith_pyott	keith_pyott
shaun_chen	shaun_chen
henry_wenman	henry_wenman
andreas_bethmann	andreas_bethmann
esther_sandoval	esther_sandoval
yoichi_numata	yoichi_numata
rolf_sohlman	rolf_sohlman
kristara_barrington	kristara_barrington
mitsuo_senda	mitsuo_senda
kwan_tak-hing	kwan_tak-hing
katsuya_kobayashi	katsuya_kobayashi
carl-axel_heiknert	carl-axel_heiknert
priya_anjali_rai	priya_anjali_rai
mako_midori	mako_midori
brooke_ballentyne	brooke_ballentyne
yua_aida	yua_aida
hiroko_mita	hiroko_mita
thomas_ong	thomas_ong
nina_roberts	nina_roberts
olisa_odele	olisa_odele
dario_coates	dario_coates
kaylani_lei	kaylani_lei
victor_stanley	victor_stanley
fang_shu	fang_shu
may_lo	may_lo
tomoyo_harada	tomoyo_harada
carole_lin	carole_lin
chihiro_hasegawa	chihiro_hasegawa
yoshi_amao	yoshi_amao
georg_funkquist	georg_funkquist
heather_vandeven	heather_vandeven
yukari_fukui	yukari_fukui
kyle_stone	kyle_stone
mitsuru_hirata	mitsuru_hirata
maria_ozawa	maria_ozawa
mili_jay	mili_jay
misa_uehara_(actress,_born_1983)	misa_uehara_(actress,_born_1983)
michiko_tanaka	michiko_tanaka
james_larkin_(actor)	james_larkin_(actor)
vivian_wu	vivian_wu
liu_peiqi	liu_peiqi
birger_lensander	birger_lensander
karole_rocher	karole_rocher
maddy_o'reilly	maddy_o'reilly
denise_ho	denise_ho
maurice_baquet	maurice_baquet
kenneth_buckley	kenneth_buckley
serena_fang	serena_fang
minami_aoyama	minami_aoyama
jake_maskall	jake_maskall
william_san	william_san
toby_leung	toby_leung
hitomi_takahashi_(actress)	hitomi_takahashi_(actress)
kate_fahy	kate_fahy
chad_alva	chad_alva
ayumi_ishida_(actress)	ayumi_ishida_(actress)
jean_dara	jean_dara
lulu_popplewell	lulu_popplewell
brianna_love	brianna_love
michiru_yuimoto	michiru_yuimoto
kevin_cheng	kevin_cheng
camilla_sparv	camilla_sparv
li_wenhai_(actor)	li_wenhai_(actor)
takeshi_tsuruno	takeshi_tsuruno
beccy_armory	beccy_armory
mark_ryder	mark_ryder
noel_coleman	noel_coleman
kotomi_kyono	kotomi_kyono
harvey_spencer_stephens	harvey_spencer_stephens
philip_stainton	philip_stainton
stephen_hancock	stephen_hancock
erica_carlson	erica_carlson
riria_yoshikawa	riria_yoshikawa
rodney_diak	rodney_diak
hugh_simon	hugh_simon
marie_miyake	marie_miyake
michael_audreson	michael_audreson
bai_hong	bai_hong
isabelle_corey	isabelle_corey
sally_oliver	sally_oliver
yasuhiro_takato	yasuhiro_takato
xu_huanshan	xu_huanshan
hiroshi_mikami	hiroshi_mikami
mark_cheng	mark_cheng
alysson_paradis	alysson_paradis
liu_yifei	liu_yifei
talvin_demachio	talvin_demachio
caroline_milmoe	caroline_milmoe
yasuhisa_furuhara	yasuhisa_furuhara
yuta_kanai	yuta_kanai
konomi_maeda	konomi_maeda
jean-baptiste_nicolet	jean-baptiste_nicolet
cheung_siu-fai	cheung_siu-fai
george_mccluskey_(actor)	george_mccluskey_(actor)
robert_sidaway_(actor)	robert_sidaway_(actor)
claude_maki	claude_maki
natasha_parry	natasha_parry
janet_henfrey	janet_henfrey
keiko_aizawa	keiko_aizawa
franceska_jaimes	franceska_jaimes
aubrey_mather	aubrey_mather
manning_haynes	manning_haynes
fay_helm	fay_helm
ben_dover	ben_dover
xavier_saint-macary	xavier_saint-macary
wilde_oscar	wilde_oscar
osman_hung	osman_hung
dennis_king	dennis_king
rob_parry	rob_parry
laure_sainclair	laure_sainclair
terence_cao	terence_cao
christine_rayner	christine_rayner
myolie_wu	myolie_wu
yoku_shioya	yoku_shioya
kazuo_hasegawa	kazuo_hasegawa
edward_shuter	edward_shuter
damian_lau	damian_lau
paul_chesterton	paul_chesterton
brenda_de_banzie	brenda_de_banzie
janine_lindemulder	janine_lindemulder
casper_chan	casper_chan
tracey_adams	tracey_adams
mehdi_belhaj_kacem	mehdi_belhaj_kacem
raven_riley	raven_riley
shizuka_hasegawa	shizuka_hasegawa
john_melin	john_melin
jennifer_evans	jennifer_evans
fine_time_fontayne	fine_time_fontayne
colette_darfeuil	colette_darfeuil
elliott_mason	elliott_mason
ian_collier	ian_collier
herbert_evans_(actor)	herbert_evans_(actor)
terence_yin	terence_yin
diana_hardcastle	diana_hardcastle
randy_spears	randy_spears
enid_stamp_taylor	enid_stamp_taylor
roger_legris	roger_legris
zhou_xun	zhou_xun
kerri_hoskins	kerri_hoskins
yuria_haga	yuria_haga
hans_ernback	hans_ernback
alice_de_winton	alice_de_winton
fiona_sit	fiona_sit
tom_coventry	tom_coventry
larry_taylor_(actor)	larry_taylor_(actor)
seiji_miyaguchi	seiji_miyaguchi
grace_ruiz	grace_ruiz
barry_wong	barry_wong
john_j._carney	john_j._carney
iain_rattray	iain_rattray
asami_sugiura	asami_sugiura
genine_graham	genine_graham
carmel_moore	carmel_moore
tyson_cane	tyson_cane
lara_roxx	lara_roxx
gustaf_hammarsten	gustaf_hammarsten
robert_horwell	robert_horwell
joan_rice	joan_rice
brian_weske	brian_weske
aino_taube	aino_taube
marla_landi	marla_landi
carman_lee	carman_lee
eriko_nakamura	eriko_nakamura
arthur_leslie	arthur_leslie
siqin_gaowa	siqin_gaowa
brian_nissen	brian_nissen
chiharu_kawai	chiharu_kawai
junko_mihara	junko_mihara
victoria_carling	victoria_carling
alex_sabga	alex_sabga
magnus_kesster	magnus_kesster
inuko_inuyama	inuko_inuyama
amber_agar	amber_agar
manami_numakura	manami_numakura
alex_fletcher_(actress)	alex_fletcher_(actress)
eelyn_kok	eelyn_kok
joe_duttine	joe_duttine
shunji_fujimura	shunji_fujimura
martin_turner_(actor)	martin_turner_(actor)
annu_mari	annu_mari
arthur_cleave	arthur_cleave
akoya_sogi	akoya_sogi
kermit_love	kermit_love
mr._marcus	mr._marcus
huang_yiliang	huang_yiliang
xander_corvus	xander_corvus
matthew_ashforde	matthew_ashforde
sun_ma_sze_tsang	sun_ma_sze_tsang
melissa_harrington	melissa_harrington
harriette_deborah_lacy	harriette_deborah_lacy
katsuhisa_namase	katsuhisa_namase
priscila_sol_(pornographic_actress)	priscila_sol_(pornographic_actress)
will_corrie	will_corrie
yu_namiki	yu_namiki
iwa_boman	iwa_boman
hisashi_igawa	hisashi_igawa
nigel_humphreys	nigel_humphreys
hilda_plowright	hilda_plowright
masato_sakai	masato_sakai
candy_chang	candy_chang
randy_cochran	randy_cochran
hans_mosesson	hans_mosesson
yumi_takada	yumi_takada
noriko_iriyama	noriko_iriyama
steven_pacey	steven_pacey
jun_konno_(voice_actor)	jun_konno_(voice_actor)
eric_hales	eric_hales
courtney_simpson	courtney_simpson
shigenori_yamazaki	shigenori_yamazaki
toshiya_ueda	toshiya_ueda
sindee_coxx	sindee_coxx
nako_mizusawa	nako_mizusawa
hans_klinga	hans_klinga
marvin_goldhar	marvin_goldhar
fumio_watanabe	fumio_watanabe
lewis_gilbert_(actor)	lewis_gilbert_(actor)
charlene_choi	charlene_choi
yui_kano	yui_kano
sandra_romain	sandra_romain
draghixa_laurent	draghixa_laurent
gerald_rawlinson	gerald_rawlinson
jane_gurnett	jane_gurnett
andrew_hall_(actor)	andrew_hall_(actor)
tamara_lees	tamara_lees
lolo_ferrari	lolo_ferrari
atsuko_yuya	atsuko_yuya
saburo_date	saburo_date
patrick_ludlow	patrick_ludlow
rei_igarashi	rei_igarashi
miriam_yeung	miriam_yeung
prue_clarke	prue_clarke
frankie_lam	frankie_lam
will_adamsdale	will_adamsdale
marc_pickering	marc_pickering
kuriko_namino	kuriko_namino
paul_bigley	paul_bigley
charmaine_sheh	charmaine_sheh
arthur_young_(actor)	arthur_young_(actor)
christopher_milburn	christopher_milburn
angela_clarke	angela_clarke
sanae_miyuki	sanae_miyuki
roger_vincent	roger_vincent
james_grout	james_grout
satine_phoenix	satine_phoenix
katashi_ishizuka	katashi_ishizuka
layla_rivera	layla_rivera
lasse_krantz	lasse_krantz
george_lam	george_lam
ivy_close	ivy_close
leilani_leeane	leilani_leeane
elizabeth_younger	elizabeth_younger
rosette_(actress)	rosette_(actress)
ann_stephens	ann_stephens
careena_collins	careena_collins
charles_le_bargy	charles_le_bargy
kaori_fukuhara	kaori_fukuhara
cowley_wright	cowley_wright
keiko_hanagata	keiko_hanagata
mina_anwar	mina_anwar
annette_benson	annette_benson
roland_curram	roland_curram
gracie_glam	gracie_glam
georgina_redhead	georgina_redhead
martin_savage_(actor)	martin_savage_(actor)
caroline_tillette	caroline_tillette
keith_wickham	keith_wickham
chiharu_tezuka	chiharu_tezuka
mark_singleton_(actor)	mark_singleton_(actor)
wilfred_shine	wilfred_shine
tanya_lopert	tanya_lopert
norman_pierce	norman_pierce
reiko_oshida	reiko_oshida
aubrey_fitzgerald	aubrey_fitzgerald
katsumi_suzuki	katsumi_suzuki
claire_guyot	claire_guyot
janet_lees_price	janet_lees_price
kasumi_nakane	kasumi_nakane
shuji_kashiwabara	shuji_kashiwabara
mitsuko_mito	mitsuko_mito
vicky_vette	vicky_vette
michael_melia	michael_melia
fiona_hampton	fiona_hampton
lauritz_falk	lauritz_falk
kiyomitsu_mizuuchi	kiyomitsu_mizuuchi
charles_goldner	charles_goldner
junko_kusayanagi	junko_kusayanagi
takuzo_kawatani	takuzo_kawatani
marilyn_chambers	marilyn_chambers
carole_baillien	carole_baillien
michitaka_kobayashi	michitaka_kobayashi
takanori_hoshino	takanori_hoshino
margaret_ashcroft	margaret_ashcroft
mikiho_niwa	mikiho_niwa
trina_michaels	trina_michaels
lisa_lipps	lisa_lipps
matthieu_boujenah	matthieu_boujenah
stanley_caine	stanley_caine
scott_haran	scott_haran
john_ramm	john_ramm
alex_mackenzie	alex_mackenzie
jessica_drake	jessica_drake
hitomi_kobayashi	hitomi_kobayashi
jessica_jaymes	jessica_jaymes
chan_shen	chan_shen
risa_taneda	risa_taneda
leo_giamani	leo_giamani
nicholas_saputra	nicholas_saputra
claude_nollier	claude_nollier
bengt_logardt	bengt_logardt
vic_chou	vic_chou
shao_bing	shao_bing
bowie_lam	bowie_lam
nana_natsume	nana_natsume
anita_wall	anita_wall
ryo_hitomi	ryo_hitomi
yui_ichikawa	yui_ichikawa
stefani_morgan	stefani_morgan
irene_tripod	irene_tripod
lily_labeau	lily_labeau
chen_xiaoxu	chen_xiaoxu
anthony_wong_(hong_kong_actor)	anthony_wong_(hong_kong_actor)
sei_ashina	sei_ashina
tae_kimura	tae_kimura
enzo_squillino,_jr.	enzo_squillino,_jr.
yoko_aki	yoko_aki
akiho_yoshizawa	akiho_yoshizawa
machiko_toyoshima	machiko_toyoshima
zhou_xuan	zhou_xuan
nicholas_mcgaughey	nicholas_mcgaughey
lee_turnbull_(actor)	lee_turnbull_(actor)
huguette_duflos	huguette_duflos
anastasia_mayo	anastasia_mayo
kimberly_kane	kimberly_kane
kanichi_kurita	kanichi_kurita
ruby_lin	ruby_lin
francesca_le	francesca_le
blanche_forsythe	blanche_forsythe
theo_stevenson	theo_stevenson
miyuki_ono	miyuki_ono
rick_pantera	rick_pantera
naomi_wakabayashi	naomi_wakabayashi
avis_bunnage	avis_bunnage
angela_white	angela_white
brent_everett	brent_everett
birgitta_pettersson	birgitta_pettersson
matilda_grahn	matilda_grahn
sacha_briquet	sacha_briquet
olivia_del_rio	olivia_del_rio
freddy_dalton	freddy_dalton
marthe_mercadier	marthe_mercadier
sophia_santi	sophia_santi
kazuko_sugiyama	kazuko_sugiyama
eric_li_(actor)	eric_li_(actor)
jamie_brooks_(actress)	jamie_brooks_(actress)
edvin_adolphson	edvin_adolphson
chen_liping	chen_liping
lauren_phoenix	lauren_phoenix
christina_schollin	christina_schollin
steven_ma	steven_ma
siv_ericks	siv_ericks
anneli_martini	anneli_martini
gilbert_lam	gilbert_lam
mutsuko_sakura	mutsuko_sakura
ryuya_wakaba	ryuya_wakaba
mandy_cho	mandy_cho
henry_mollison	henry_mollison
rosemary_leach	rosemary_leach
sosuke_ikematsu	sosuke_ikematsu
jacky_chu	jacky_chu
henri_garat	henri_garat
mirai_moriyama	mirai_moriyama
paul_crauchet	paul_crauchet
jin_chao-chun	jin_chao-chun
helen_longworth	helen_longworth
reiko_kataoka	reiko_kataoka
ben_cartwright_(actor)	ben_cartwright_(actor)
chang_chen-yue	chang_chen-yue
anna_godenius	anna_godenius
alexis_texas	alexis_texas
konami_yoshida	konami_yoshida
tanner_mayes	tanner_mayes
gareth_pierce	gareth_pierce
judy_minx	judy_minx
lucia_giannecchini	lucia_giannecchini
wanda_curtis	wanda_curtis
dyanne_thorne	dyanne_thorne
miriam_(tv_personality)	miriam_(tv_personality)
chieko_honda	chieko_honda
billy_dee	billy_dee
jenaveve_jolie	jenaveve_jolie
hyo-sei	hyo-sei
simon_dutton	simon_dutton
aki_tomosaki	aki_tomosaki
karin_kavli	karin_kavli
felix_lok	felix_lok
anthony_aston	anthony_aston
shu_qi	shu_qi
kentaro_shimizu	kentaro_shimizu
momoko_shibuya	momoko_shibuya
naomi_kawashima	naomi_kawashima
danny_wylde	danny_wylde
tanya_hyde	tanya_hyde
sif_ruud	sif_ruud
ikue_kimura	ikue_kimura
deborah_manship	deborah_manship
paola_dionisotti	paola_dionisotti
teresa_mo	teresa_mo
rachel_de_solla	rachel_de_solla
ayumi_ito	ayumi_ito
lilli_carati	lilli_carati
sally_yeh	sally_yeh
kurumi_mamiya	kurumi_mamiya
douglas_munro_(actor)	douglas_munro_(actor)
nakamura_utaemon_ii	nakamura_utaemon_ii
matt_littler	matt_littler
torsten_lilliecrona	torsten_lilliecrona
yumi_uchiyama	yumi_uchiyama
lin_gengxin	lin_gengxin
mioko_fujiwara	mioko_fujiwara
stoya	stoya
honami_tajima	honami_tajima
masaya_takatsuka	masaya_takatsuka
nicole_barber-lane	nicole_barber-lane
wong_he	wong_he
miho_shiraishi	miho_shiraishi
robin_byrd	robin_byrd
michelle_newell	michelle_newell
john_paul_(actor)	john_paul_(actor)
zhu_houren	zhu_houren
junzaburo_ban	junzaburo_ban
olof_widgren	olof_widgren
erika_yazawa	erika_yazawa
shirley_yeung	shirley_yeung
chikage_awashima	chikage_awashima
anna_polina	anna_polina
ronny_jhutti	ronny_jhutti
kenji_matsuda	kenji_matsuda
leonard_sharp	leonard_sharp
harry_ahlin	harry_ahlin
rhonda_jo_petty	rhonda_jo_petty
yukari_tachibana	yukari_tachibana
eric_swiss	eric_swiss
billy_milton	billy_milton
bernard_le_coq	bernard_le_coq
benny_chan_(actor)	benny_chan_(actor)
maud_hansson	maud_hansson
roger_dutoit	roger_dutoit
narumi_yasuda	narumi_yasuda
david_gooderson	david_gooderson
hy_hazell	hy_hazell
dominique_davray	dominique_davray
alice_tissot	alice_tissot
takashi_hagino	takashi_hagino
hazel_tucker	hazel_tucker
kanako_maeda	kanako_maeda
daizen_shishido	daizen_shishido
papaya_suzuki	papaya_suzuki
bertil_anderberg	bertil_anderberg
jessie_andrews	jessie_andrews
andrew_mcnair_(actor)	andrew_mcnair_(actor)
rob_cryston	rob_cryston
blake_harper	blake_harper
jack_venice	jack_venice
dai_matsumoto	dai_matsumoto
vicki_carpenter	vicki_carpenter
olla_ramlan	olla_ramlan
justin_lo	justin_lo
mahito_tsujimura	mahito_tsujimura
julian_chagrin	julian_chagrin
audrey_hollander	audrey_hollander
maria_sundbom	maria_sundbom
roland_armontel	roland_armontel
caroline_harker	caroline_harker
jeanna_fine	jeanna_fine
julien_rassam	julien_rassam
arata_iura	arata_iura
nina_mercedez	nina_mercedez
chuy_bravo	chuy_bravo
tom_bennett_(actor)	tom_bennett_(actor)
arthur_malet	arthur_malet
brian_gwaspari	brian_gwaspari
ian_davidson_(scriptwriter)	ian_davidson_(scriptwriter)
atsuko_takahata	atsuko_takahata
jean-baptiste_puech	jean-baptiste_puech
angela_pan	angela_pan
jordan_metcalfe	jordan_metcalfe
firmine_richard	firmine_richard
kesarin_chaichalermpol	kesarin_chaichalermpol
yuki_ito_(actor)	yuki_ito_(actor)
ao_takahashi	ao_takahashi
maurice_risch	maurice_risch
takanori_jinnai	takanori_jinnai
sam_battersea	sam_battersea
sally_george	sally_george
jacky_cheung	jacky_cheung
britta_holmberg	britta_holmberg
gerald_lawrence	gerald_lawrence
ikki_sawamura	ikki_sawamura
hsiao_ho_(actor)	hsiao_ho_(actor)
riku_moriyama	riku_moriyama
india_fisher	india_fisher
jacques_duby	jacques_duby
edwin_siu	edwin_siu
oscar_ljung	oscar_ljung
kan'ami	kan'ami
ian_gouw	ian_gouw
itsumi_osawa	itsumi_osawa
mikiko_miki	mikiko_miki
wellington_a._playter	wellington_a._playter
ashley_long	ashley_long
katharine_levy	katharine_levy
derek_ware_(actor)	derek_ware_(actor)
gunnar_nielsen_(actor)	gunnar_nielsen_(actor)
rachel_davies	rachel_davies
kurumi_morishita	kurumi_morishita
toshiharu_sakurai	toshiharu_sakurai
du_chun	du_chun
donnie_yen	donnie_yen
devang_patel	devang_patel
chi_kuan-chun	chi_kuan-chun
haddy_jallow	haddy_jallow
hiroki_hasegawa	hiroki_hasegawa
patrick_cremin	patrick_cremin
zhao_wei	zhao_wei
darren_lim	darren_lim
billy_lau	billy_lau
samir_guesmi	samir_guesmi
maria_takagi	maria_takagi
cameron_butterwick	cameron_butterwick
per_eggers	per_eggers
tore_svennberg	tore_svennberg
georg_rydeberg	georg_rydeberg
hiro_nakajima	hiro_nakajima
adele_wong	adele_wong
xiang_yun	xiang_yun
eri_miyajima	eri_miyajima
sydney_paxton	sydney_paxton
fan_hung-hsuan	fan_hung-hsuan
barry_k._barnes	barry_k._barnes
lois_ayres	lois_ayres
chan_hung-lit	chan_hung-lit
dora_venter	dora_venter
harue_akagi	harue_akagi
arihiro_fujimura	arihiro_fujimura
teresa_carpio	teresa_carpio
kazusa_murai	kazusa_murai
adam_paul_harvey	adam_paul_harvey
shun_miyazato	shun_miyazato
anja_juliette_laval	anja_juliette_laval
natasja_vermeer	natasja_vermeer
ben_wong	ben_wong
claire_nielson	claire_nielson
gordon_lam	gordon_lam
joanna_phillips-lane	joanna_phillips-lane
makoto_tsumura	makoto_tsumura
hong_huifang	hong_huifang
judy_gunn	judy_gunn
kristina_rose	kristina_rose
adam_campbell_(actor)	adam_campbell_(actor)
masato_uchiyama	masato_uchiyama
alexandra_quinn	alexandra_quinn
samantha_robson	samantha_robson
ken_uehara	ken_uehara
philippe_dean	philippe_dean
lou_gish	lou_gish
mayura_hoshitsuki	mayura_hoshitsuki
puff_kuo	puff_kuo
darren_john_langford	darren_john_langford
colin_blumenau	colin_blumenau
winnie_lau	winnie_lau
valen_hsu	valen_hsu
barry_livesey	barry_livesey
marlene_willoughby	marlene_willoughby
noname_jane	noname_jane
philip_strange	philip_strange
derrick_pierce	derrick_pierce
naomi_hosokawa	naomi_hosokawa
chisato_morishita	chisato_morishita
silas_carson	silas_carson
zuo_xiaoqing	zuo_xiaoqing
ben_english	ben_english
bolo_yeung	bolo_yeung
betty_fields	betty_fields
daisy_marie	daisy_marie
toshiyuki_nagashima	toshiyuki_nagashima
david_thwaites	david_thwaites
kathleen_worth	kathleen_worth
tasha_voux	tasha_voux
raul_cristian	raul_cristian
chen_zeyu	chen_zeyu
abigail_clayton	abigail_clayton
samuel_hui	samuel_hui
muriel_mayette	muriel_mayette
zhu_yuchen	zhu_yuchen
patric_doonan	patric_doonan
max_hardcore	max_hardcore
alexia_portal	alexia_portal
gianna_michaels	gianna_michaels
james_harcourt	james_harcourt
angel_chiang	angel_chiang
david_weatherley	david_weatherley
chelsea_blue	chelsea_blue
elvin_ng	elvin_ng
sheila_chan	sheila_chan
april_flores	april_flores
nacho_vidal	nacho_vidal
sayuri_yoshida	sayuri_yoshida
fan_bingbing	fan_bingbing
beatrice_pons	beatrice_pons
alain_claessens	alain_claessens
shintaro_yamada	shintaro_yamada
naomi_nagasawa	naomi_nagasawa
andrew_pleavin	andrew_pleavin
john_lone	john_lone
kunihiko_yasui	kunihiko_yasui
deobia_oparei	deobia_oparei
andie_chen	andie_chen
regina_russell	regina_russell
jacques_charby	jacques_charby
paul_colline	paul_colline
bryan_powley	bryan_powley
qin_hao	qin_hao
melissa_monet	melissa_monet
tim_holmes_(actor)	tim_holmes_(actor)
hande_kodja	hande_kodja
andy_hui	andy_hui
don_knight_(actor)	don_knight_(actor)
doreen_mantle	doreen_mantle
masao_shimizu	masao_shimizu
amanda_davin	amanda_davin
connor_marsh	connor_marsh
takahiro_tamura	takahiro_tamura
minase_yashiro	minase_yashiro
shauna_macdonald	shauna_macdonald
henry_krauss	henry_krauss
karin_foley	karin_foley
lauderdale_maitland	lauderdale_maitland
elizabeth_cassidy	elizabeth_cassidy
michael_anderson,_jr.	michael_anderson,_jr.
hina_kamimura	hina_kamimura
amita_dhiri	amita_dhiri
may_ling_su	may_ling_su
isla_bevan	isla_bevan
lionel_d'aragon	lionel_d'aragon
leon_lai	leon_lai
tasha_reign	tasha_reign
fred_cheng	fred_cheng
ng_hui	ng_hui
alec_b._francis	alec_b._francis
chika_anzai	chika_anzai
natasha_gray	natasha_gray
wayne_lai	wayne_lai
chiyoko_kawashima	chiyoko_kawashima
yuuki_matsuda	yuuki_matsuda
philippe_chevallier_(actor)	philippe_chevallier_(actor)
maki_meguro	maki_meguro
hugh_buckler	hugh_buckler
john_ryder_(actor)	john_ryder_(actor)
hideki_tasaka	hideki_tasaka
kristen_bjorn	kristen_bjorn
masashi_sugawara	masashi_sugawara
rose_stradner	rose_stradner
ludmilla_radchenko	ludmilla_radchenko
joseph_caillot	joseph_caillot
kotaro_koizumi	kotaro_koizumi
tom_byron	tom_byron
zig_byfield	zig_byfield
candy_chu	candy_chu
hampe_faustman	hampe_faustman
shigeru_muroi	shigeru_muroi
charmane_star	charmane_star
capri_anderson	capri_anderson
tamsin_heatley	tamsin_heatley
elvis_tsui	elvis_tsui
kurt_marshall	kurt_marshall
shun_sugata	shun_sugata
annie_chen	annie_chen
liz_edmiston	liz_edmiston
joe_cole_(actor)	joe_cole_(actor)
marguerite_de_morlaye	marguerite_de_morlaye
rin_asuka	rin_asuka
dean_phoenix	dean_phoenix
ivy_chen	ivy_chen
charles_dera	charles_dera
henry_o	henry_o
nobuo_kaneko	nobuo_kaneko
maki_hojo	maki_hojo
william_so	william_so
feng_xiaogang	feng_xiaogang
siobhan_o'neill	siobhan_o'neill
maudie_dunham	maudie_dunham
sarah-jane_potts	sarah-jane_potts
annie_liu	annie_liu
natalia_starr	natalia_starr
jacques_legras	jacques_legras
seth_gamble	seth_gamble
michiko_hada	michiko_hada
karin_lannby	karin_lannby
sarah_thomas_(actress)	sarah_thomas_(actress)
carter_stevens	carter_stevens
alex_descas	alex_descas
med_reventberg	med_reventberg
johnny_sekka	johnny_sekka
tomas_bolme	tomas_bolme
venus_lux	venus_lux
ami_yamazaki	ami_yamazaki
edmund_chen	edmund_chen
tami_monroe	tami_monroe
lizz_tayler	lizz_tayler
lo_lieh	lo_lieh
ning_jing	ning_jing
shelagh_fraser	shelagh_fraser
selena_tan	selena_tan
stanley_logan	stanley_logan
jin_katagiri	jin_katagiri
apple_hong	apple_hong
ami_ayukawa	ami_ayukawa
bryden_murdoch	bryden_murdoch
tyler_faith	tyler_faith
albert_burdon	albert_burdon
tommy_hansen	tommy_hansen
pierre_bellemare	pierre_bellemare
hilton_edwards	hilton_edwards
aimee-ffion_edwards	aimee-ffion_edwards
alexander_fu_sheng	alexander_fu_sheng
nathalie_lunghi	nathalie_lunghi
kanako_sakai	kanako_sakai
zhang_yang_(director)	zhang_yang_(director)
jack_denton	jack_denton
arinze_kene	arinze_kene
fredrik_dolk	fredrik_dolk
kitten_natividad	kitten_natividad
tsugumi_higasayama	tsugumi_higasayama
sanae_takagi	sanae_takagi
barry_howard	barry_howard
jasmin_st._claire	jasmin_st._claire
diana_davies_(actress)	diana_davies_(actress)
yoshio_kawai	yoshio_kawai
emily_jewell	emily_jewell
kaori_oguri	kaori_oguri
karen_mayo-chandler	karen_mayo-chandler
gordon_liu	gordon_liu
ann-sofie_kylin	ann-sofie_kylin
hiroko_kasahara	hiroko_kasahara
ai_iwamura	ai_iwamura
dru_berrymore	dru_berrymore
ana_mulvoy-ten	ana_mulvoy-ten
ben_webster_(actor)	ben_webster_(actor)
gary_raymond	gary_raymond
debbie_russ	debbie_russ
claude_dampier	claude_dampier
cavan_clerkin	cavan_clerkin
derek_tsang	derek_tsang
hjalmar_selander	hjalmar_selander
monika_kaelin	monika_kaelin
andrea_habay	andrea_habay
takahisa_maeyama	takahisa_maeyama
nicolas_giraud	nicolas_giraud
frank_perfitt	frank_perfitt
richard_cowley	richard_cowley
freddie_popplewell	freddie_popplewell
cornell_john	cornell_john
hiroshi_koizumi	hiroshi_koizumi
yoko_tsukasa	yoko_tsukasa
mavis_fan	mavis_fan
olga_kosakiewicz	olga_kosakiewicz
elizabeth_bennett_(actress)	elizabeth_bennett_(actress)
jan_molander	jan_molander
jacques_herlin	jacques_herlin
simon_lack	simon_lack
takeshi_miura	takeshi_miura
julie_neubert	julie_neubert
dunia_montenegro	dunia_montenegro
rose_vestris	rose_vestris
johan_paulik	johan_paulik
nanami_sakuraba	nanami_sakuraba
chinatsu_akasaki	chinatsu_akasaki
liljay	liljay
akira_kobayashi	akira_kobayashi
ian_hallard	ian_hallard
terence_longdon	terence_longdon
lauren_phillips	lauren_phillips
katrine_boorman	katrine_boorman
john_macandrews	john_macandrews
griselda_yeung	griselda_yeung
breck_stewart	breck_stewart
mona_malm	mona_malm
brian_surewood	brian_surewood
mado_maurin	mado_maurin
pan_hong	pan_hong
donnelly_rhodes	donnelly_rhodes
michelle_chia	michelle_chia
reginald_long	reginald_long
don_li	don_li
janice_man	janice_man
celine_ma	celine_ma
charlie_young_(actress)	charlie_young_(actress)
bunko_kanazawa	bunko_kanazawa
erika_okuda	erika_okuda
lemon_hanazawa	lemon_hanazawa
merle_tottenham	merle_tottenham
michelle_herbert	michelle_herbert
kimberly_carson	kimberly_carson
bernard_musson	bernard_musson
liu_xiaoqing	liu_xiaoqing
saya_misaki	saya_misaki
miki_nagasawa	miki_nagasawa
ryuzou_ishino	ryuzou_ishino
anne_heung	anne_heung
masami_horiuchi	masami_horiuchi
west_digges	west_digges
yurin_(actress)	yurin_(actress)
teri_tordai	teri_tordai
blade_thompson	blade_thompson
harry_locke	harry_locke
issey_ogata	issey_ogata
helena_brodin	helena_brodin
ayana_sasagawa	ayana_sasagawa
sakura_sakurada	sakura_sakurada
carl_billquist	carl_billquist
hiromi_murata	hiromi_murata
liu_tao	liu_tao
hao_lei	hao_lei
mayumi_shintani	mayumi_shintani
emiri_henmi	emiri_henmi
hiroyuki_watanabe	hiroyuki_watanabe
tsuyoshi_koyama	tsuyoshi_koyama
jiro_wang	jiro_wang
ashlyn_gere	ashlyn_gere
rebecca_lord	rebecca_lord
amy_fisher	amy_fisher
ralph_arliss	ralph_arliss
carina_lau	carina_lau
tricia_devereaux	tricia_devereaux
maureen_o'farrell	maureen_o'farrell
keith_jayne	keith_jayne
wendy_williams_(actress)	wendy_williams_(actress)
angela_glynne	angela_glynne
yuka_koyama	yuka_koyama
yumiko_hosono	yumiko_hosono
shinobu_satouchi	shinobu_satouchi
mayuki_makiguchi	mayuki_makiguchi
seiji_kumagai	seiji_kumagai
per_morberg	per_morberg
angelina_armani	angelina_armani
denys_graham	denys_graham
sam_wang_(actor)	sam_wang_(actor)
ting-ting_hu	ting-ting_hu
edna_best	edna_best
xiao_man	xiao_man
simon_edward_stokes	simon_edward_stokes
nat_ho	nat_ho
nozomu_sasaki	nozomu_sasaki
kingone_wang	kingone_wang
ayumi_shigemori	ayumi_shigemori
masayuki_deai	masayuki_deai
danny_mountain	danny_mountain
noriko_watanabe	noriko_watanabe
jun_masuo	jun_masuo
debbie_rush	debbie_rush
gordon_craig_(actor)	gordon_craig_(actor)
tomomi_miyashita	tomomi_miyashita
alice_chan	alice_chan
marica_hase	marica_hase
michelle_chen	michelle_chen
lena_nyman	lena_nyman
louisa_moritz	louisa_moritz
gerd_andersson	gerd_andersson
fukumi_kuroda	fukumi_kuroda
eileen_yeow	eileen_yeow
leo_gregory	leo_gregory
terence_ford	terence_ford
shinobu_otake	shinobu_otake
thomas_hellberg	thomas_hellberg
hisaya_morishige	hisaya_morishige
anna_ishibashi	anna_ishibashi
wang_yan_(actress)	wang_yan_(actress)
shinji_kawada	shinji_kawada
clare-hope_ashitey	clare-hope_ashitey
leonard_williams_(actor)	leonard_williams_(actor)
carmella_bing	carmella_bing
george_dewhurst	george_dewhurst
tabatha_cash	tabatha_cash
sister_roma	sister_roma
li_lili	li_lili
stephen_boxer	stephen_boxer
bruce_lee	bruce_lee
grace_kirby	grace_kirby
connie_chan	connie_chan
michael_miu	michael_miu
marie_mccray	marie_mccray
dylan_kuo	dylan_kuo
atsuko_sakuraba	atsuko_sakuraba
vincent_chiao	vincent_chiao
joanna_jet	joanna_jet
shauna_o'brien	shauna_o'brien
sam_livesey	sam_livesey
peter_martin_(actor)	peter_martin_(actor)
naho_ozawa	naho_ozawa
hiroyuki_onoue	hiroyuki_onoue
sally_bazely	sally_bazely
risa_coda	risa_coda
robert_cox_(actor)	robert_cox_(actor)
he_saifei	he_saifei
anna_calder-marshall	anna_calder-marshall
nikolai_kinski	nikolai_kinski
christiane_delyne	christiane_delyne
roxy_deville	roxy_deville
yutaka_matsushige	yutaka_matsushige
natsuna_watanabe	natsuna_watanabe
louis_willoughby	louis_willoughby
jack_livesey	jack_livesey
nelson_keys	nelson_keys
otoya_kawano	otoya_kawano
chang_chen	chang_chen
mark_lee_(comedian)	mark_lee_(comedian)
henry_djanik	henry_djanik
honey_wilder	honey_wilder
ivo_dawson	ivo_dawson
curt_masreliez	curt_masreliez
alfred_hsing	alfred_hsing
brett_mycles	brett_mycles
mick_blue	mick_blue
richard_cunningham_(actor)	richard_cunningham_(actor)
elarica_gallacher	elarica_gallacher
stefan_wong_(actor)	stefan_wong_(actor)
grace_wong	grace_wong
eriko_watanabe	eriko_watanabe
yuto_nakano	yuto_nakano
walter_byron_(actor)	walter_byron_(actor)
ong_ai_leng	ong_ai_leng
shanna_mccullough	shanna_mccullough
martin_boddey	martin_boddey
dick_webb	dick_webb
belladonna_(actress)	belladonna_(actress)
waise_lee	waise_lee
guy_bellis	guy_bellis
kazunori_yokoo	kazunori_yokoo
shoko_goto	shoko_goto
joanne_heywood	joanne_heywood
tamaki_matsumoto	tamaki_matsumoto
kurt_lockwood	kurt_lockwood
norman_wooland	norman_wooland
riona_hazuki	riona_hazuki
lewis_shaw	lewis_shaw
miki_fujitani	miki_fujitani
daniel_wu	daniel_wu
laura_angel	laura_angel
emily_chu	emily_chu
linda_armstrong	linda_armstrong
selena_li	selena_li
kyle_bradford	kyle_bradford
stuart_mcloughlin	stuart_mcloughlin
nikki_dial	nikki_dial
philip_latham	philip_latham
mercy_hatton	mercy_hatton
natsuko_yamamoto	natsuko_yamamoto
ulf_johanson	ulf_johanson
barbara_cason	barbara_cason
lee_kang-sheng	lee_kang-sheng
totti_truman_taylor	totti_truman_taylor
ivy_duke	ivy_duke
wang_zi	wang_zi
sheri_st._claire	sheri_st._claire
adrianna_luna	adrianna_luna
katy_kung	katy_kung
mei_ting	mei_ting
monica_sweetheart	monica_sweetheart
mary_woodvine	mary_woodvine
shauna_grant	shauna_grant
miyuki_matsushita	miyuki_matsushita
liu_wai-hung	liu_wai-hung
roger_alborough	roger_alborough
tatsuya_nagatomo	tatsuya_nagatomo
janine_chang	janine_chang
john_harryson	john_harryson
michiko_nomura	michiko_nomura
frank_conroy_(actor)	frank_conroy_(actor)
charles_quatermaine	charles_quatermaine
simone_james	simone_james
elizabeth_chambers_(actress)	elizabeth_chambers_(actress)
rino_katase	rino_katase
shaun_curry	shaun_curry
prinzzess	prinzzess
george_hulse	george_hulse
georgia_king	georgia_king
dan_young	dan_young
louis_mahoney	louis_mahoney
tamao_hayashi	tamao_hayashi
charles_morgan_(actor)	charles_morgan_(actor)
miwa_takada	miwa_takada
hilda_bayley	hilda_bayley
mark_chao	mark_chao
motomu_kiyokawa	motomu_kiyokawa
ma_tianyu	ma_tianyu
takashi_taguchi_(actor)	takashi_taguchi_(actor)
miho_fujima	miho_fujima
annie_cruz	annie_cruz
selina_jen	selina_jen
jun_azumi_(voice_actor)	jun_azumi_(voice_actor)
alfred_hui	alfred_hui
go_jibiki	go_jibiki
minnie_rayner	minnie_rayner
matthew_kane_(actor)	matthew_kane_(actor)
roger_rowland	roger_rowland
pauline_brailsford	pauline_brailsford
karen_dior	karen_dior
ben_hawkey	ben_hawkey
liliane_nemri	liliane_nemri
makoto_yuki	makoto_yuki
guy_newall	guy_newall
shawn_lee_(actor)	shawn_lee_(actor)
chiharu_suzuka	chiharu_suzuka
jeff_palmer	jeff_palmer
sue_longhurst	sue_longhurst
keiko_takeshita	keiko_takeshita
koji_furuhata	koji_furuhata
fred_morgan_(actor)	fred_morgan_(actor)
devinn_lane	devinn_lane
dean_harris	dean_harris
harold_warrender	harold_warrender
jessica_darlin	jessica_darlin
brendon_miller	brendon_miller
zhao_tao	zhao_tao
damien_crosse	damien_crosse
nana_katase	nana_katase
denice_klarskov	denice_klarskov
natalie_tong	natalie_tong
leslie_bovee	leslie_bovee
ikuya_sawaki	ikuya_sawaki
geoffrey_davies	geoffrey_davies
george_hu	george_hu
mikako_ichikawa	mikako_ichikawa
aislinn_o'neill	aislinn_o'neill
jacques_balutin	jacques_balutin
john_ruddock	john_ruddock
richard_cooper_(actor)	richard_cooper_(actor)
joey_stefano	joey_stefano
rikki_six	rikki_six
george_skillan	george_skillan
sacha_alexander	sacha_alexander
desiree_west	desiree_west
roman_tam	roman_tam
eve_matheson	eve_matheson
chocoball_mukai	chocoball_mukai
alan_tam	alan_tam
isao_kimura	isao_kimura
kandi_barbour	kandi_barbour
vi_kaley	vi_kaley
keni_styles	keni_styles
minoru_watanabe	minoru_watanabe
lini_evans	lini_evans
nana_yanagisawa	nana_yanagisawa
justine_joli	justine_joli
nick_shen	nick_shen
jolene_chin	jolene_chin
michelle_yeoh	michelle_yeoh
mariko_kawana	mariko_kawana
kay_parker	kay_parker
vincent_ng	vincent_ng
karen_lancaume	karen_lancaume
frederick_hall_(actor)	frederick_hall_(actor)
hubert_willis	hubert_willis
subaru_kimura	subaru_kimura
richard_standing	richard_standing
jenny_funnell	jenny_funnell
arthur_margetson	arthur_margetson
joseph_tremain	joseph_tremain
mina_(voice_actress)	mina_(voice_actress)
tomoko_nakajima	tomoko_nakajima
onoe_shoroku_ii	onoe_shoroku_ii
clara_morgane	clara_morgane
megan_leigh	megan_leigh
charlie_laine	charlie_laine
jimmy_lin	jimmy_lin
chen_baoguo	chen_baoguo
ben_faulks	ben_faulks
kunie_tanaka	kunie_tanaka
ernst_eklund_(actor)	ernst_eklund_(actor)
cindy_au	cindy_au
julie_tan	julie_tan
stephen_chow	stephen_chow
lisa_ann	lisa_ann
leif_liljeroth	leif_liljeroth
michael_hawkins_(british_actor)	michael_hawkins_(british_actor)
li_xiaoran	li_xiaoran
zhang_jizhong	zhang_jizhong
alien_huang	alien_huang
lau_kar-wing	lau_kar-wing
prudence_liew	prudence_liew
mimi_lo	mimi_lo
riley_steele	riley_steele
vincent_zhao	vincent_zhao
nie_yuan	nie_yuan
kenji_anan	kenji_anan
liana_bridges	liana_bridges
dorothy_gordon	dorothy_gordon
owen_roughwood	owen_roughwood
katherine_jakeways	katherine_jakeways
patrick_chesnais	patrick_chesnais
yvonne_schaloske	yvonne_schaloske
cassidey	cassidey
eitaro_ozawa	eitaro_ozawa
kim_anderzon	kim_anderzon
emil_forselius	emil_forselius
takashi_aoyagi	takashi_aoyagi
ai_haneda	ai_haneda
fumina_hara	fumina_hara
eiji_maruyama	eiji_maruyama
vicki_richter	vicki_richter
zhou_mi_(singer)	zhou_mi_(singer)
seika_kuze	seika_kuze
chu_ke-liang	chu_ke-liang
nenji_kobayashi	nenji_kobayashi
megumi_kubota	megumi_kubota
douglas_johansson	douglas_johansson
michel_beaune	michel_beaune
kaoru_kuroki	kaoru_kuroki
chor_yuen	chor_yuen
stuart_smith_(actor)	stuart_smith_(actor)
rena_tanaka	rena_tanaka
clifford_mollison	clifford_mollison
gretchen_(singer)	gretchen_(singer)
kelly_chen	kelly_chen
adam_thomas	adam_thomas
gao_yuanyuan	gao_yuanyuan
arletta_duncan	arletta_duncan
wu_xiubo	wu_xiubo
xie_shaoguang	xie_shaoguang
judith_baldwin	judith_baldwin
bernard_natan	bernard_natan
ken_chang	ken_chang
ayaka_hibiki	ayaka_hibiki
kim_clifford	kim_clifford
yuko_takayama	yuko_takayama
fernand_charpin	fernand_charpin
elizabeth_rider	elizabeth_rider
peggy_simpson	peggy_simpson
c.v._france	c.v._france
vanessa_demouy	vanessa_demouy
donald_eccles	donald_eccles
matthew_crompton	matthew_crompton
masataka_azuma	masataka_azuma
stephen_ewart	stephen_ewart
tabitha_stevens	tabitha_stevens
arthur_hardy_(actor)	arthur_hardy_(actor)
zhang_hanyu	zhang_hanyu
beckett_bould	beckett_bould
joanne_peh	joanne_peh
ann_zacharias	ann_zacharias
tiger_tyson	tiger_tyson
marcus_chin	marcus_chin
philippe_nicaud	philippe_nicaud
mikio_narita	mikio_narita
mayumi_yamamoto	mayumi_yamamoto
anneliese_van_der_pol	anneliese_van_der_pol
michael_standing_(actor)	michael_standing_(actor)
mark_lawrence_(actor)	mark_lawrence_(actor)
ken_kensei	ken_kensei
dicky_cheung	dicky_cheung
noriko_tatsumi	noriko_tatsumi
anabel_barnston	anabel_barnston
yuki_masuda	yuki_masuda
brittney_skye	brittney_skye
james_lindsay_(actor)	james_lindsay_(actor)
daniela_amavia	daniela_amavia
a.j._applegate	a.j._applegate
anissa_kate	anissa_kate
uschi_digard	uschi_digard
peter_madden_(actor)	peter_madden_(actor)
dale_meeks	dale_meeks
allan_wu	allan_wu
anne_crawford	anne_crawford
linda_lovelace	linda_lovelace
zhu_xijuan	zhu_xijuan
hiromi_nagasaku	hiromi_nagasaku
keri_windsor	keri_windsor
jack_wrangler	jack_wrangler
marcel_vibert	marcel_vibert
wilson_coleman	wilson_coleman
catalina_cruz	catalina_cruz
tamaki_katori	tamaki_katori
zena_marshall	zena_marshall
diana_beaumont	diana_beaumont
hikari_ishida	hikari_ishida
sylvia_chang	sylvia_chang
hiroyuki_miyasako	hiroyuki_miyasako
susan_beaumont	susan_beaumont
melissa_lauren	melissa_lauren
frida_hallgren	frida_hallgren
yumeji_tsukioka	yumeji_tsukioka
roxanne_hall	roxanne_hall
shelley_rees	shelley_rees
charles_lloyd-pack	charles_lloyd-pack
carl_forgione	carl_forgione
piers_flint-shipman	piers_flint-shipman
barbro_oborg	barbro_oborg
francesco_malcom	francesco_malcom
tyce_bune	tyce_bune
maho_toyota	maho_toyota
rie_yamaguchi	rie_yamaguchi
runa_akasaka	runa_akasaka
hotaru_hazuki	hotaru_hazuki
forbes_collins	forbes_collins
taisuke_yamamoto	taisuke_yamamoto
alicia_rio	alicia_rio
tom_brooke	tom_brooke
jeanne_de_casalis	jeanne_de_casalis
karl_gerhard	karl_gerhard
jean-pierre_kalfon	jean-pierre_kalfon
billy_chow	billy_chow
ai_tokunaga	ai_tokunaga
taryn_thomas	taryn_thomas
chieko_aioi	chieko_aioi
ix_shen	ix_shen
michelle_ye	michelle_ye
kate_more	kate_more
benjamin_smith_(actor)	benjamin_smith_(actor)
shinobu_adachi	shinobu_adachi
ella_koon	ella_koon
geoffrey_davion	geoffrey_davion
agnes-nicole_winter	agnes-nicole_winter
matt_chow	matt_chow
steve_shaw_(actor)	steve_shaw_(actor)
heshima_thompson	heshima_thompson
vivian_schmitt	vivian_schmitt
guje_lagerwall	guje_lagerwall
agneta_eckemyr	agneta_eckemyr
hinako_saeki	hinako_saeki
nozomi_sasaki_(voice_actress)	nozomi_sasaki_(voice_actress)
chems_dahmani	chems_dahmani
michiyo_okusu	michiyo_okusu
choky_ice	choky_ice
tokio_seki	tokio_seki
michaela_schaffrath	michaela_schaffrath
skye_bennett	skye_bennett
steve_sarossy	steve_sarossy
madeleine_milhaud	madeleine_milhaud
issei_miyazaki	issei_miyazaki
akiko_nishina	akiko_nishina
saori_hara	saori_hara
tiffany_mynx	tiffany_mynx
aaron_kwok	aaron_kwok
chiharu_kitaoka	chiharu_kitaoka
ceri_jackson	ceri_jackson
kimber_james	kimber_james
daphne_rye	daphne_rye
daniel_portman	daniel_portman
fushigi_yamada	fushigi_yamada
nicholas_tse	nicholas_tse
poppy_morgan	poppy_morgan
joachim_kessef	joachim_kessef
amy_dalby	amy_dalby
yu_lan	yu_lan
lecatte-folleville	lecatte-folleville
sabrina_blond	sabrina_blond
steve_ma	steve_ma
yuka_hoshaku	yuka_hoshaku
tsurutaro_kataoka	tsurutaro_kataoka
jade_seah	jade_seah
claude_bertrand_(actor)	claude_bertrand_(actor)
shoko_aida	shoko_aida
jean_worms	jean_worms
charles_cooper_(actor)	charles_cooper_(actor)
carlo_gabriel_nero	carlo_gabriel_nero
siri_svegler	siri_svegler
hiroko_yamashita_(actress)	hiroko_yamashita_(actress)
joyce_cheng	joyce_cheng
helga_thomas	helga_thomas
ravi_kapoor	ravi_kapoor
taeko_nakanishi	taeko_nakanishi
tomoko_maruo	tomoko_maruo
mami_kingetsu	mami_kingetsu
anksa_kara	anksa_kara
mikie_hara	mikie_hara
sissela_kyle	sissela_kyle
florence_kwok	florence_kwok
sarah_kazemy	sarah_kazemy
christiana_horton	christiana_horton
eiko_masuyama	eiko_masuyama
regan_reese	regan_reese
agnes_lauchlan	agnes_lauchlan
gabrielle_robinne	gabrielle_robinne
thomas_h._macdonald	thomas_h._macdonald
dallas_cairns	dallas_cairns
bernard_tiphaine	bernard_tiphaine
jason_hawke	jason_hawke
kang_cheng_xi	kang_cheng_xi
sandy_lam	sandy_lam
jay_simpson_(actor)	jay_simpson_(actor)
kenji_ebisawa	kenji_ebisawa
justin_pickett	justin_pickett
erica_campbell	erica_campbell
gunnel_fred	gunnel_fred
shawn_dou	shawn_dou
eve_angel	eve_angel
jun_fubuki	jun_fubuki
frank_petley	frank_petley
atsushi_harada	atsushi_harada
angela_morant	angela_morant
christopher_bramwell	christopher_bramwell
seika_hosokawa	seika_hosokawa
vivian_chow	vivian_chow
kayoko_fujii	kayoko_fujii
mai_takahashi	mai_takahashi
gem_souleyman	gem_souleyman
nozomi_momoi	nozomi_momoi
yammie_lam	yammie_lam
alec_powers	alec_powers
nica_noelle	nica_noelle
valia	valia
jam_hsiao	jam_hsiao
hugh_latimer_(actor)	hugh_latimer_(actor)
margaret_yarde	margaret_yarde
suzanne_dalbert	suzanne_dalbert
daniel_fathers	daniel_fathers
daniel_boulanger	daniel_boulanger
suki_chui	suki_chui
dylan_ryder	dylan_ryder
sarah-jane_gwillim	sarah-jane_gwillim
ian_hogg_(actor)	ian_hogg_(actor)
andrew_langtree	andrew_langtree
maureen_darbyshire	maureen_darbyshire
michel_etcheverry	michel_etcheverry
joe_melia	joe_melia
fridolf_rhudin	fridolf_rhudin
bao_guo'an	bao_guo'an
stella_farentino	stella_farentino
john_hopkins_(actor)	john_hopkins_(actor)
fortesa_hoti	fortesa_hoti
wan_yeung-ming	wan_yeung-ming
reon_kadena	reon_kadena
lily_leung	lily_leung
hacken_lee	hacken_lee
zhang_guoqiang	zhang_guoqiang
virginie_gervais	virginie_gervais
roland_giraud	roland_giraud
ellesmere_choi	ellesmere_choi
dong_jie	dong_jie
janice_mckenzie	janice_mckenzie
roy_herrick	roy_herrick
loretta_yang	loretta_yang
jim_o'connolly	jim_o'connolly
jacques_henley	jacques_henley
mayumi_yamaguchi	mayumi_yamaguchi
julia_joyce	julia_joyce
juliet_anderson	juliet_anderson
daphne_heard	daphne_heard
hung_sin-nui	hung_sin-nui
valda_setterfield	valda_setterfield
aria_giovanni	aria_giovanni
peter_bull	peter_bull
sophia_rossi	sophia_rossi
ruthie_henshall	ruthie_henshall
wolf_hudson	wolf_hudson
lawrence_chou	lawrence_chou
richard_heffer	richard_heffer
michael_lucas_(director)	michael_lucas_(director)
katsumi_toriumi	katsumi_toriumi
eva_fontaine	eva_fontaine
takamasa_suga	takamasa_suga
eiji_okuda	eiji_okuda
shy_love	shy_love
tomoe_hanba	tomoe_hanba
jamie_gillis	jamie_gillis
samantha_strong	samantha_strong
mona_geijer-falkner	mona_geijer-falkner
dana_dearmond	dana_dearmond
genie_chuo	genie_chuo
pelle_seth	pelle_seth
tish_ambrose	tish_ambrose
mayumi_asaka	mayumi_asaka
sarah_vandella	sarah_vandella
ayano_murasaki	ayano_murasaki
ado_endoh	ado_endoh
richard_mayes	richard_mayes
mari_ayukawa	mari_ayukawa
cheng_gwan-min	cheng_gwan-min
ava_vincent	ava_vincent
john_garrick	john_garrick
pace_wu	pace_wu
arthur_cullin	arthur_cullin
jesseca_liu	jesseca_liu
serena_gordon	serena_gordon
brewster_mason	brewster_mason
malin_ek	malin_ek
sara_nakayama	sara_nakayama
debi_diamond	debi_diamond
kinya_aikawa	kinya_aikawa
helge_skoog	helge_skoog
ingrid_janbell	ingrid_janbell
chen_xiao	chen_xiao
sandrine_kiberlain	sandrine_kiberlain
jean-pierre_lorit	jean-pierre_lorit
alexandra_lamy	alexandra_lamy
walter_hudd	walter_hudd
vidkid_timo	vidkid_timo
takuma_takewaka	takuma_takewaka
ted_thin_elk	ted_thin_elk
bruce_le	bruce_le
kathy_chow	kathy_chow
jess_sum	jess_sum
gerald_ames	gerald_ames
dawn_acton	dawn_acton
aiko_horiuchi	aiko_horiuchi
pascal_white	pascal_white
john_bernard_(actor)	john_bernard_(actor)
cyril_luckham	cyril_luckham
law_wing-cheung	law_wing-cheung
miwa_yasuda	miwa_yasuda
toshiko_sawada	toshiko_sawada
robert_rendel	robert_rendel
kayoko_kishimoto	kayoko_kishimoto
ui_miyazaki	ui_miyazaki
robin_brockway	robin_brockway
madison_stone	madison_stone
howard_gaye	howard_gaye
g.e.m._(singer)	g.e.m._(singer)
walter_tennyson	walter_tennyson
robert_vahey	robert_vahey
bree_olson	bree_olson
yonehiko_kitagawa	yonehiko_kitagawa
guo_tao_(actor)	guo_tao_(actor)
alp_haydar	alp_haydar
patrick_alexandroni	patrick_alexandroni
runa_akiyama	runa_akiyama
charlotte_stokely	charlotte_stokely
deng_jiajia	deng_jiajia
nana_ozaki_(actress)	nana_ozaki_(actress)
sam_costa	sam_costa
sune_mangs	sune_mangs
colin_chase	colin_chase
leilani_gaja	leilani_gaja
harper_marshall	harper_marshall
meredith_macneill	meredith_macneill
stephen_wong_ka-lok	stephen_wong_ka-lok
sunny_lane	sunny_lane
wiska	wiska
kaya_matsutani	kaya_matsutani
elaiza_ikeda	elaiza_ikeda
annabel_leventon	annabel_leventon
jules_jordan	jules_jordan
cleveland_campbell	cleveland_campbell
coco_lee	coco_lee
kaitlyn_ashley	kaitlyn_ashley
ryder_skye	ryder_skye
johnnie_schofield	johnnie_schofield
frank_atkinson_(actor)	frank_atkinson_(actor)
malcolm_cherry	malcolm_cherry
berta_hall	berta_hall
matthew_guinness	matthew_guinness
emmanuel_jacomy	emmanuel_jacomy
gill_mohindepaul_singh	gill_mohindepaul_singh
jo_rowbottom	jo_rowbottom
scott_gerbacia	scott_gerbacia
cecilia_cheung	cecilia_cheung
jean_kemm	jean_kemm
mayumi_ogawa	mayumi_ogawa
nicola_reynolds	nicola_reynolds
chen_hong_(actress)	chen_hong_(actress)
hilary_pritchard	hilary_pritchard
nicolas_duvauchelle	nicolas_duvauchelle
asa_akira	asa_akira
john_seeman	john_seeman
megumi_makihara	megumi_makihara
dawson_millward	dawson_millward
daisy_campbell	daisy_campbell
eiji_kanie	eiji_kanie
a.b._imeson	a.b._imeson
barbara_gott	barbara_gott
stephen_clancy_hill	stephen_clancy_hill
jade_starr	jade_starr
mayumi_asano	mayumi_asano
ulla_jacobsson	ulla_jacobsson
tarra_white	tarra_white
linda_hardy	linda_hardy
jean_marchat	jean_marchat
winifred_harris	winifred_harris
wallace_huo	wallace_huo
gloria_leonard	gloria_leonard
antonia_de_sancha	antonia_de_sancha
priscilla_wong	priscilla_wong
nancy_wu	nancy_wu
helen_noble	helen_noble
anikka_albrite	anikka_albrite
lena_nitro	lena_nitro
benny_haag	benny_haag
brian_miller_(actor)	brian_miller_(actor)
paule_andral	paule_andral
kazunari_tanaka	kazunari_tanaka
henry_saari	henry_saari
pan_lingling	pan_lingling
ran_masaki	ran_masaki
chew_chor_meng	chew_chor_meng
nick_chou	nick_chou
bengt_djurberg	bengt_djurberg
alfred_lundberg	alfred_lundberg
faith_brook	faith_brook
nadia_styles	nadia_styles
lacie_heart	lacie_heart
ben_yeo	ben_yeo
jeremy_brock	jeremy_brock
andy_hockley	andy_hockley
linus_wahlgren	linus_wahlgren
jiz_lee	jiz_lee
richard_howard_(actor)	richard_howard_(actor)
shinichi_tsutsumi	shinichi_tsutsumi
yumi_shirakawa	yumi_shirakawa
christian_marin	christian_marin
nicholas_teo	nicholas_teo
john_oxley_(actor)	john_oxley_(actor)
anna_savva	anna_savva
richard_estcourt	richard_estcourt
mami_kosuge	mami_kosuge
stuart_wade	stuart_wade
hugh_sinclair_(actor)	hugh_sinclair_(actor)
rumiko_koyanagi	rumiko_koyanagi
go_shinomiya	go_shinomiya
mutsumi_tamura	mutsumi_tamura
joe_cheng	joe_cheng
shogo_yamaguchi	shogo_yamaguchi
bobby_troup	bobby_troup
magda_miller	magda_miller
paw_hee-ching	paw_hee-ching
tania_russof	tania_russof
kascha_papillon	kascha_papillon
hidetaka_yoshioka	hidetaka_yoshioka
lori_chow	lori_chow
edward_sorley	edward_sorley
martha_cope	martha_cope
margit_manstad	margit_manstad
cate_harrington	cate_harrington
namewee	namewee
ku_feng	ku_feng
stacy_jefferson	stacy_jefferson
anita_yuen	anita_yuen
frederick_pyne	frederick_pyne
allan_bohlin	allan_bohlin
brandy_aniston	brandy_aniston
zeng_huifen	zeng_huifen
edmond_leung	edmond_leung
farid_chopel	farid_chopel
hayford_hobbs	hayford_hobbs
murasaki_wakaba	murasaki_wakaba
julian_harries	julian_harries
mio_takaki	mio_takaki
naozumi_takahashi	naozumi_takahashi
zhang_yaodong	zhang_yaodong
vera_cornish	vera_cornish
justin_slayer	justin_slayer
gwen_garci	gwen_garci
minna_grey	minna_grey
mika_tan	mika_tan
ernest_a._douglas	ernest_a._douglas
claude_melki	claude_melki
mia_malkova	mia_malkova
siu_yam-yam	siu_yam-yam
kazuyuki_okitsu	kazuyuki_okitsu
charles_mortimer	charles_mortimer
britta_brunius	britta_brunius
bethan_ellis_owen	bethan_ellis_owen
dada_chan	dada_chan
mie_kitahara	mie_kitahara
wen_zhang	wen_zhang
sakura_ando	sakura_ando
rita_cadillac_(brazilian_entertainer)	rita_cadillac_(brazilian_entertainer)
julia_ann	julia_ann
paul_shearer	paul_shearer
arthur_bostrom	arthur_bostrom
jay_laurier	jay_laurier
ren_yexiang	ren_yexiang
johan_rabaeus	johan_rabaeus
julia_chambers	julia_chambers
nicolas_bataille	nicolas_bataille
erica_fontes	erica_fontes
sia_berkeley	sia_berkeley
michelle_joseph	michelle_joseph
holly_lucas	holly_lucas
miki_mizuno	miki_mizuno
jet_li	jet_li
jean-pierre_bernard	jean-pierre_bernard
horace_hodges	horace_hodges
meggie_albanesi	meggie_albanesi
su_xing	su_xing
caryn_richman	caryn_richman
kazuya_tatekabe	kazuya_tatekabe
jenny_ulving	jenny_ulving
jj_jia	jj_jia
mike_he	mike_he
maria_cordero	maria_cordero
erica_yuen	erica_yuen
jessica_sweet	jessica_sweet
yang_libing	yang_libing
daisy_cordell	daisy_cordell
lizzie_mickery	lizzie_mickery
yohanna_idha	yohanna_idha
george_fant	george_fant
shouma_yamamoto	shouma_yamamoto
michael_stefano	michael_stefano
walter_latham	walter_latham
kate_mcgregor	kate_mcgregor
anthony_crane	anthony_crane
chiaki_maeda	chiaki_maeda
gail_force	gail_force
tyra_misoux	tyra_misoux
alexis_fire	alexis_fire
cynthia_khan	cynthia_khan
abella_anderson	abella_anderson
selena_steele	selena_steele
maki_mizuno	maki_mizuno
megumi_sato_(actress)	megumi_sato_(actress)
nathan_stewart-jarrett	nathan_stewart-jarrett
gabrielle_brune	gabrielle_brune
tatsuya_fuji	tatsuya_fuji
deep_ng	deep_ng
aleska_diamond	aleska_diamond
jonathan_linsley	jonathan_linsley
takayuki_yamaguchi	takayuki_yamaguchi
lucile_saint-simon	lucile_saint-simon
gareth_thomas_(actor)	gareth_thomas_(actor)
nautica_thorn	nautica_thorn
eiji_okada	eiji_okada
alan_gifford	alan_gifford
ginny_holder	ginny_holder
sasha_grey	sasha_grey
jamie_borthwick	jamie_borthwick
jim_mcmanus_(british_actor)	jim_mcmanus_(british_actor)
alex_reid_(actress)	alex_reid_(actress)
vickery_turner	vickery_turner
eiko_ando	eiko_ando
lung_fong	lung_fong
annie_esmond	annie_esmond
oscar_leung	oscar_leung
milk_ichigo	milk_ichigo
johnnie_keyes	johnnie_keyes
ringo_aoba	ringo_aoba
lou_cass	lou_cass
margo_gunn	margo_gunn
anzu_nagai	anzu_nagai
shelbee_myne	shelbee_myne
du_zhiguo	du_zhiguo
saki_seto	saki_seto
gail_sheridan	gail_sheridan
jonathan_watson	jonathan_watson
samuel_le_bihan	samuel_le_bihan
nobuko_miyamoto	nobuko_miyamoto
amy_ried	amy_ried
mineko_nishikawa	mineko_nishikawa
mayu_kotono	mayu_kotono
jamie_treacher	jamie_treacher
elaine_yiu	elaine_yiu
ray_lui	ray_lui
masuimi_max	masuimi_max
chen_hao_(actress)	chen_hao_(actress)
gong_qiuxia	gong_qiuxia
angelina_valentine	angelina_valentine
marguerite_moreno	marguerite_moreno
jin_horikawa	jin_horikawa
jeffrey_lau	jeffrey_lau
taiki_matsuno	taiki_matsuno
anna_cropper	anna_cropper
larry_noble_(actor)	larry_noble_(actor)
tatsuo_yamada	tatsuo_yamada
michelle_reis	michelle_reis
hitomi_kuroki	hitomi_kuroki
nadine_marshall	nadine_marshall
jonas_karlsson	jonas_karlsson
zhang_tielin	zhang_tielin
louise_plowright	louise_plowright
toshihiko_nakajima	toshihiko_nakajima
bobby_hollander	bobby_hollander
sven_lindberg	sven_lindberg
chris_wang_(actor)	chris_wang_(actor)
tee_reel	tee_reel
minoru_yada	minoru_yada
mimi_chu	mimi_chu
jana_jordan	jana_jordan
stephen_fung	stephen_fung
akifumi_miura	akifumi_miura
teddy_robin	teddy_robin
dyanna_lauren	dyanna_lauren
yoko_matsugane	yoko_matsugane
jeannie_pepper	jeannie_pepper
henri_cogan	henri_cogan
arthur_walcott	arthur_walcott
reiko_takashima	reiko_takashima
mao_di	mao_di
li_chen_(actor)	li_chen_(actor)
naemi_briese	naemi_briese
paul_ready	paul_ready
helen_haye	helen_haye
helena_af_sandeberg	helena_af_sandeberg
taka_kato	taka_kato
catherine_chau	catherine_chau
chase_hunter	chase_hunter
teresa_orlowski	teresa_orlowski
omar_galanti	omar_galanti
marjorie_rhodes	marjorie_rhodes
michael_sharvell-martin	michael_sharvell-martin
martin_troakes	martin_troakes
andrew_mackintosh	andrew_mackintosh
amy_chan	amy_chan
bojan_westin	bojan_westin
yuko_sasamoto	yuko_sasamoto
shinnosuke_furumoto	shinnosuke_furumoto
chow_chung	chow_chung
david_king-wood	david_king-wood
chen_sicheng	chen_sicheng
anthony_hardwood	anthony_hardwood
estelle_skornik	estelle_skornik
humberston_wright	humberston_wright
joseph_kpobie	joseph_kpobie
kana_yume	kana_yume
charmaine_li	charmaine_li
michael_j._cox	michael_j._cox
angela_summers	angela_summers
melvil_poupaud	melvil_poupaud
charles_oliver_(actor)	charles_oliver_(actor)
marie-laure_dougnac	marie-laure_dougnac
ernest_sefton	ernest_sefton
vince_vouyer	vince_vouyer
christoph_clark	christoph_clark
halina_tam	halina_tam
chizuru_ikewaki	chizuru_ikewaki
mami_nakamura	mami_nakamura
lesley_wareing	lesley_wareing
akira_kubo	akira_kubo
akio_nojima	akio_nojima
yuma_ishigaki	yuma_ishigaki
lisa_s.	lisa_s.
william_hung	william_hung
kristal_summers	kristal_summers
batdorj-in_baasanjab	batdorj-in_baasanjab
nikita_gross	nikita_gross
ming_dao	ming_dao
xie_na	xie_na
patricia_maynard	patricia_maynard
lucie_jeanne	lucie_jeanne
david_sterne	david_sterne
robert_vallis	robert_vallis
kenix_kwok	kenix_kwok
john_welsh_(actor)	john_welsh_(actor)
zara_whites	zara_whites
zheng_junli	zheng_junli
lacey_duvalle	lacey_duvalle
trevor_reid	trevor_reid
krister_classon	krister_classon
lilian_bond	lilian_bond
kerstin_granlund	kerstin_granlund
richard_lynch_(welsh_actor)	richard_lynch_(welsh_actor)
chung_king-fai	chung_king-fai
daniella_rush	daniella_rush
eiko_nagashima	eiko_nagashima
masayo_hosono	masayo_hosono
naruki_matsukawa	naruki_matsukawa
rei_okamoto	rei_okamoto
shingo_tsurumi	shingo_tsurumi
kaoru_shimamura	kaoru_shimamura
roy_cheung	roy_cheung
valentina_nappi	valentina_nappi
long_jeanne_silver	long_jeanne_silver
sayoko_ohashi	sayoko_ohashi
david_dencik	david_dencik
valentine_tessier	valentine_tessier
frank_dane	frank_dane
candy_samples	candy_samples
mathilde_seigner	mathilde_seigner
nike_arrighi	nike_arrighi
hans_zhang	hans_zhang
maria_yamamoto	maria_yamamoto
steve_railsback	steve_railsback
king_kong_lam	king_kong_lam
peggy_carlisle	peggy_carlisle
douglas_payne	douglas_payne
paulina_james	paulina_james
awa_ly	awa_ly
hans-christian_thulin	hans-christian_thulin
shellz_zhu	shellz_zhu
cara_lott	cara_lott
carmen_luvana	carmen_luvana
david_crellin	david_crellin
fumi_hirano	fumi_hirano
yu_chenghui	yu_chenghui
kobe_tai	kobe_tai
syd_courtenay	syd_courtenay
huang_shengyi	huang_shengyi
kathryn_drysdale	kathryn_drysdale
jon_laurimore	jon_laurimore
cecil_morton_york	cecil_morton_york
matt_yeung	matt_yeung
briana_banks	briana_banks
mari_hoshino	mari_hoshino
charles_holland_(actor)	charles_holland_(actor)
lena_halliday	lena_halliday
tony_scoggo	tony_scoggo
armand_kaliz	armand_kaliz
sigrid_holmquist	sigrid_holmquist
karl_erik_flens	karl_erik_flens
huang_xiaoming	huang_xiaoming
christer_boustedt	christer_boustedt
ceara_o'neill	ceara_o'neill
vincenzo_pellegrino	vincenzo_pellegrino
azumi_asakura	azumi_asakura
rakuto_tochihara	rakuto_tochihara
micheline_dax	micheline_dax
manfred_wong	manfred_wong
kaku_takashina	kaku_takashina
sally_yoshino	sally_yoshino
jose_duval	jose_duval
mari_nishio	mari_nishio
christine_kuo	christine_kuo
kate_bracken	kate_bracken
mckenzie_lee	mckenzie_lee
billy_hartman	billy_hartman
juri_nagatsuma	juri_nagatsuma
deborah_norton	deborah_norton
jacqueline_defferary	jacqueline_defferary
shermon_tang	shermon_tang
philip_merivale	philip_merivale
naoko_watanabe_(voice_actress)	naoko_watanabe_(voice_actress)
anders_ek	anders_ek
michiko_hamamura	michiko_hamamura
annabel_maule	annabel_maule
gary_bakewell	gary_bakewell
colleen_brennan	colleen_brennan
bosco_wong	bosco_wong
sammy_sum	sammy_sum
matsuri_mizuguchi	matsuri_mizuguchi
martin_ljung	martin_ljung
gabrielle_hamilton_(actress)	gabrielle_hamilton_(actress)
erica_ellyson	erica_ellyson
till_kraemer	till_kraemer
georgann_johnson	georgann_johnson
tom_reynolds_(actor)	tom_reynolds_(actor)
li_xiaolu	li_xiaolu
campbell_gullan	campbell_gullan
joy_allen	joy_allen
erica_boyer	erica_boyer
joey_meng	joey_meng
michelle_ferre	michelle_ferre
conleth_hill	conleth_hill
crawford_logan	crawford_logan
charles_heslop	charles_heslop
bak_man-biu	bak_man-biu
hiromi_tsunakake	hiromi_tsunakake
tsui_siu-ming	tsui_siu-ming
mami_horikoshi	mami_horikoshi
ranko_hanai	ranko_hanai
jean_chapot	jean_chapot
michiko_maeda	michiko_maeda
charles_carson_(actor)	charles_carson_(actor)
alice_miyuki	alice_miyuki
muriel_frances_dana	muriel_frances_dana
hisayo_mochizuki	hisayo_mochizuki
joshua_ang	joshua_ang
yukie_maeda	yukie_maeda
king_kong_lee	king_kong_lee
baron_chen	baron_chen
antonia_kinlay	antonia_kinlay
hilda_moore	hilda_moore
ebba_hultkvist	ebba_hultkvist
monica_vera	monica_vera
pamela_green	pamela_green
david_gale_(actor)	david_gale_(actor)
jenny_tschernichin-larsson	jenny_tschernichin-larsson
van_damage	van_damage
deric_wan	deric_wan
mai_sekiguchi	mai_sekiguchi
jeremi_cockram	jeremi_cockram
teru_shimada	teru_shimada
geoffrey_chater	geoffrey_chater
katja_kassin	katja_kassin
ian_saynor	ian_saynor
wallace_bosco	wallace_bosco
alice_hirose	alice_hirose
reiko_yasuhara	reiko_yasuhara
raven_alexis	raven_alexis
mami_deguchi	mami_deguchi
roy_stewart	roy_stewart
noriko_sengoku	noriko_sengoku
maya_gold	maya_gold
nana_yamaguchi	nana_yamaguchi
fraser_ayres	fraser_ayres
hiro_hayama	hiro_hayama
momoko_ishikawa	momoko_ishikawa
miyuki_ueda	miyuki_ueda
julia_taylor	julia_taylor
betty_faire	betty_faire
sachiko_murase	sachiko_murase
kaneta_kimotsuki	kaneta_kimotsuki
hirohiko_kakegawa	hirohiko_kakegawa
lito_cruz	lito_cruz
henry_longhurst_(actor)	henry_longhurst_(actor)
amanda_langlet	amanda_langlet
jimmy_vee	jimmy_vee
sarah_song	sarah_song
geoff_hoyle	geoff_hoyle
candy_apples	candy_apples
henri_castelli	henri_castelli
tyrell_davis	tyrell_davis
silvia_saint	silvia_saint
diane_fletcher	diane_fletcher
sandrine_pinna	sandrine_pinna
julie_night	julie_night
rakel_liekki	rakel_liekki
shiho_fujimura	shiho_fujimura
joyzelle_joyner	joyzelle_joyner
ryo_kimura	ryo_kimura
ryoko_yonekura	ryoko_yonekura
muga_takewaki	muga_takewaki
ingrid_luterkort	ingrid_luterkort
mia_murano	mia_murano
marianne_aminoff	marianne_aminoff
tomiko_ishii	tomiko_ishii
takeshi_kaneshiro	takeshi_kaneshiro
will_payne_(actor)	will_payne_(actor)
harry_korris	harry_korris
victoria_gould	victoria_gould
matthew_marsh_(actor)	matthew_marsh_(actor)
mohamed_mahmoud_abdel_aziz	mohamed_mahmoud_abdel_aziz
diana_pang	diana_pang
kellyanne_farquhar	kellyanne_farquhar
benjamin_johnson	benjamin_johnson
sinn_sage	sinn_sage
brandi_love	brandi_love
shiho_kikuchi	shiho_kikuchi
henric_holmberg	henric_holmberg
amber_rayne	amber_rayne
jean_marsan	jean_marsan
kin_sugai	kin_sugai
mat_ruttle	mat_ruttle
kristy_yang	kristy_yang
guy_disilva	guy_disilva
max_van_ville	max_van_ville
leslie_perrins	leslie_perrins
joan_lockton	joan_lockton
bengt_ekerot	bengt_ekerot
sayaka_kanda	sayaka_kanda
francesco_d'macho	francesco_d'macho
seiichi_tanabe	seiichi_tanabe
lottie_blackford	lottie_blackford
charlene_tse	charlene_tse
joy_garrett	joy_garrett
casey_donovan_(actor)	casey_donovan_(actor)
miles_long	miles_long
lisa_lu	lisa_lu
erika_mabuchi	erika_mabuchi
yorke_sherwood	yorke_sherwood
mayuko_aoki	mayuko_aoki
isao_tamagawa	isao_tamagawa
ma_sanli	ma_sanli
rod_fontana	rod_fontana
nakamura_utaemon_i	nakamura_utaemon_i
yoshinori_okada	yoshinori_okada
makiko_kuno	makiko_kuno
caroline_woodruff	caroline_woodruff
kelly_lin	kelly_lin
yukiko_iwai	yukiko_iwai
lezley_zen	lezley_zen
bruno_pradal	bruno_pradal
erina_yamazaki	erina_yamazaki
david_frankham	david_frankham
sue_hodge	sue_hodge
ishia_bennison	ishia_bennison
janet_dibley	janet_dibley
william_snape	william_snape
bengt_dalqvist	bengt_dalqvist
armand_dutertre	armand_dutertre
deidre_holland	deidre_holland
roberto_malone	roberto_malone
nami_kurokawa	nami_kurokawa
kiki_vidis	kiki_vidis
polly_ward	polly_ward
johnni_black	johnni_black
sarah-jane_varley	sarah-jane_varley
francis_perrin_(actor)	francis_perrin_(actor)
bryan_leung	bryan_leung
su_ling	su_ling
kei_tanaka	kei_tanaka
karin_bertling	karin_bertling
ashley_fires	ashley_fires
arthur_rigby_(actor)	arthur_rigby_(actor)
brigitta_bulgari	brigitta_bulgari
sakura_sena	sakura_sena
ryoko_watanabe	ryoko_watanabe
masato_furuoya	masato_furuoya
leslie_bradley	leslie_bradley
segol_mann	segol_mann
rene_bond	rene_bond
geraldine_o'rawe	geraldine_o'rawe
caroline_carver_(actor)	caroline_carver_(actor)
alan_tang	alan_tang
dan_ekborg	dan_ekborg
masami_hisamoto	masami_hisamoto
nicholas_le_prevost	nicholas_le_prevost
sam_smith_(actor)	sam_smith_(actor)
barbie_hsu	barbie_hsu
teddy_arundell	teddy_arundell
saburo_kamei	saburo_kamei
adel_bencherif	adel_bencherif
lorna_lewis_(actress)	lorna_lewis_(actress)
ilona_staller	ilona_staller
macy_chan	macy_chan
matthew_jay_lewis	matthew_jay_lewis
barbara_dare	barbara_dare
stanley_meadows	stanley_meadows
gigi_leung	gigi_leung
andreas_wilson	andreas_wilson
camilla_power	camilla_power
akemi_okamura	akemi_okamura
james_nokes	james_nokes
reika_hashimoto	reika_hashimoto
shakira_caine	shakira_caine
yang_lina	yang_lina
yumi_shimura	yumi_shimura
zhao_yihuan	zhao_yihuan
lillian_zuckerman	lillian_zuckerman
marguerite_pierry	marguerite_pierry
natalia_zeta	natalia_zeta
alexandra_rapaport	alexandra_rapaport
he_zhuoyan	he_zhuoyan
aden_gillett	aden_gillett
vincent_lindon	vincent_lindon
ann_bridgewater	ann_bridgewater
shirley_jaffe_(actress)	shirley_jaffe_(actress)
bibian_norai	bibian_norai
paige_chua	paige_chua
charlton_heston	charlton_heston
yuko_kobayashi	yuko_kobayashi
naruhito_iguchi	naruhito_iguchi
grace_chan	grace_chan
gayathri_mudigonda	gayathri_mudigonda
keiron_self	keiron_self
alun_lewis_(actor)	alun_lewis_(actor)
pierre_png	pierre_png
jean_claudio	jean_claudio
rebecca_bardoux	rebecca_bardoux
gerd_hagman	gerd_hagman
celest_chong	celest_chong
bert_parnaby	bert_parnaby
ng_man-tat	ng_man-tat
minori_aoi	minori_aoi
katy_murphy	katy_murphy
dani_daniels	dani_daniels
frederick_lloyd	frederick_lloyd
caroline_hayes	caroline_hayes
angus_mackay_(actor)	angus_mackay_(actor)
raj_ghatak	raj_ghatak
brooklyn_lee	brooklyn_lee
tara_lynn_foxx	tara_lynn_foxx
deborah_cornelius	deborah_cornelius
zheng_geping	zheng_geping
eileen_grubba	eileen_grubba
stella_madden	stella_madden
jiang_qinqin	jiang_qinqin
michiyo_kogure	michiyo_kogure
jake_deckard	jake_deckard
niki_chow	niki_chow
pierre_boulanger	pierre_boulanger
wakana_yamazaki	wakana_yamazaki
dee_hsu	dee_hsu
toni_ribas	toni_ribas
mark_daly_(actor)	mark_daly_(actor)
narumi_tsunoda	narumi_tsunoda
cariad_lloyd	cariad_lloyd
machiko_kawana	machiko_kawana
paul_frankeur	paul_frankeur
katie_morgan	katie_morgan
figge_norling	figge_norling
sammo_hung	sammo_hung
david_ellison_(british_actor)	david_ellison_(british_actor)
yuko_ito	yuko_ito
takuma_suzuki	takuma_suzuki
lesley_fitz-simons	lesley_fitz-simons
hugh_burden	hugh_burden
brooke_haven	brooke_haven
yukiji_asaoka	yukiji_asaoka
kanji_suzumori	kanji_suzumori
mary_millington	mary_millington
raylene	raylene
florence_gill	florence_gill
aya_uchida	aya_uchida
bennett_pang	bennett_pang
thomas_jouannet	thomas_jouannet
fred_yule	fred_yule
renji_ishibashi	renji_ishibashi
noriko_uemura	noriko_uemura
phil_rose	phil_rose
brittany_andrews	brittany_andrews
ayumi_oka_(actress)	ayumi_oka_(actress)
alektra_blue	alektra_blue
judy_kelly	judy_kelly
mayu_asada	mayu_asada
julie_k._smith	julie_k._smith
roxy_jezel	roxy_jezel
ryoko_kobayashi	ryoko_kobayashi
peter_perski	peter_perski
georgie_glen	georgie_glen
li_qian_(actress)	li_qian_(actress)
britney_amber	britney_amber
julian_royce	julian_royce
angela_tong	angela_tong
nobuko_otowa	nobuko_otowa
jenna_jameson	jenna_jameson
candida_royalle	candida_royalle
eva_angelina	eva_angelina
asami_kai	asami_kai
walter_fitzgerald	walter_fitzgerald
john_botvid	john_botvid
rin_aoki	rin_aoki
c._j._laing	c._j._laing
tom_kelly_(actor)	tom_kelly_(actor)
ayaka_kimura_(voice_actress)	ayaka_kimura_(voice_actress)
johnny_ngan	johnny_ngan
soh_hang-suen	soh_hang-suen
dale_dabone	dale_dabone
aaron_yan	aaron_yan
fritiof_billquist	fritiof_billquist
tollie_zellman	tollie_zellman
dina_jewel	dina_jewel
catrin_westerlund	catrin_westerlund
ady_an	ady_an
lee_macdonald	lee_macdonald
matthew_buckley	matthew_buckley
rosie_taylor-ritson	rosie_taylor-ritson
cecil_bevan	cecil_bevan
alec_wallis	alec_wallis
shogo_suzuki_(actor)	shogo_suzuki_(actor)
walt_macpherson	walt_macpherson
mai_lin	mai_lin
arpad_miklos	arpad_miklos
darren_james	darren_james
meimei_kuo	meimei_kuo
marji_campi	marji_campi
chizuko_hoshino	chizuko_hoshino
victoria_plucknett	victoria_plucknett
ryan_thomas	ryan_thomas
kenneth_ma	kenneth_ma
bobbi_bliss	bobbi_bliss
salma_de_nora	salma_de_nora
philippe_lefebvre_(actor)	philippe_lefebvre_(actor)
kristi_myst	kristi_myst
deborah_findlay	deborah_findlay
julia_dietze	julia_dietze
louise_hampton	louise_hampton
atsuko_kawada	atsuko_kawada
you_yong	you_yong
james_wen	james_wen
earl_rhodes	earl_rhodes
adrian_pang	adrian_pang
kitana_baker	kitana_baker
martin_lev	martin_lev
himesh_patel	himesh_patel
zhang_ziyi	zhang_ziyi
black_angelika	black_angelika
takuo_kawamura	takuo_kawamura
helen_goss	helen_goss
angelababy	angelababy
sarah_lam	sarah_lam
rupert_farley	rupert_farley
nina_gunke	nina_gunke
sachiko_kokubu	sachiko_kokubu
gustaf_wally	gustaf_wally
john_shrapnel	john_shrapnel
frankie_chan	frankie_chan
calli_cox	calli_cox
atsuro_watabe	atsuro_watabe
ricky_sinz	ricky_sinz
jonathan_scott_(actor)	jonathan_scott_(actor)
bianca_bai	bianca_bai
vincent_davies	vincent_davies
rinako_hirasawa	rinako_hirasawa
sara_bernat	sara_bernat
bellan_roos	bellan_roos
kris_deedigan	kris_deedigan
derek_lord	derek_lord
brett_findlay	brett_findlay
ehlo_huang	ehlo_huang
naomi_chance	naomi_chance
yoshimi_iwasaki	yoshimi_iwasaki
ryosei_konishi	ryosei_konishi
reginald_fox	reginald_fox
zhao_lirong	zhao_lirong
kathleen_vaughan	kathleen_vaughan
t._t._boy	t._t._boy
alf_kjellin	alf_kjellin
suzy_bloom	suzy_bloom
toshie_negishi	toshie_negishi
tina_leung	tina_leung
kagney_linn_karter	kagney_linn_karter
li_xuejian	li_xuejian
matt_king_(comedian)	matt_king_(comedian)
maria-elena_laas	maria-elena_laas
raquel_cassidy	raquel_cassidy
greg_centauro	greg_centauro
ken_mitsuishi	ken_mitsuishi
sharon_kane	sharon_kane
kumiko_takeda	kumiko_takeda
graeme_hawley	graeme_hawley
joel_lawrence	joel_lawrence
ken_yamaguchi	ken_yamaguchi
ma_su_(actress)	ma_su_(actress)
dany_robin	dany_robin
michael_knowles_(actor)	michael_knowles_(actor)
seiran_kobayashi	seiran_kobayashi
xiaoshenyang	xiaoshenyang
margaret_cabourn-smith	margaret_cabourn-smith
darryl_yong	darryl_yong
mysie_monte	mysie_monte
haruna_hana	haruna_hana
bernard_vaughan_(actor)	bernard_vaughan_(actor)
yoshio_inaba	yoshio_inaba
muriel_aked	muriel_aked
ted_lune	ted_lune
darby_lloyd_rains	darby_lloyd_rains
stoney_curtis	stoney_curtis
kuniko_asagi	kuniko_asagi
wilber_pan	wilber_pan
kazue_itoh	kazue_itoh
sammi_cheng	sammi_cheng
alex_etel	alex_etel
jane_slaughter_(actress)	jane_slaughter_(actress)
aino_kishi	aino_kishi
tom_swire	tom_swire
kousei_yagi	kousei_yagi
junie_astor	junie_astor
li_xiuming	li_xiuming
tomoaki_maeno	tomoaki_maeno
nikki_anderson	nikki_anderson
julian_vedey	julian_vedey
victoria_paris	victoria_paris
ayane_sakura	ayane_sakura
anthony_ireland_(actor)	anthony_ireland_(actor)
annie_lambert	annie_lambert
sheri-an_davis	sheri-an_davis
takeshi_maeda_(actor)	takeshi_maeda_(actor)
louis_yuen	louis_yuen
vittoria_risi	vittoria_risi
richard_dolman	richard_dolman
sumiko_hidaka	sumiko_hidaka
simon_nash	simon_nash
elsa_tee	elsa_tee
rosalind_ayres	rosalind_ayres
camille_de_pazzis	camille_de_pazzis
camille_bert	camille_bert
allie_haze	allie_haze
monica_dolan	monica_dolan
pierre_meyrand	pierre_meyrand
yumiko_nakajima	yumiko_nakajima
jean_del_val	jean_del_val
jemima_abey	jemima_abey
patricia_gibson-howell	patricia_gibson-howell
gene_gerrard	gene_gerrard
shiori_kanzaki	shiori_kanzaki
amber_lynn	amber_lynn
jenny_hutchinson	jenny_hutchinson
yasuko_matsuyuki	yasuko_matsuyuki
bokuzen_hidari	bokuzen_hidari
manami_yoshii	manami_yoshii
laurence_howarth	laurence_howarth
katie_sheridan	katie_sheridan
maria_mcerlane	maria_mcerlane
zhang_jingchu	zhang_jingchu
buddug_williams	buddug_williams
richard_ng	richard_ng
mike_adriano	mike_adriano
bernard_lancret	bernard_lancret
simon_roberts_(actor)	simon_roberts_(actor)
jessie_st._james	jessie_st._james
madge_tree	madge_tree
tawny_roberts	tawny_roberts
valentine_nonyela	valentine_nonyela
julie_meadows	julie_meadows
hyapatia_lee	hyapatia_lee
stephanie_swift	stephanie_swift
michael_lonsdale	michael_lonsdale
belle_chrystall	belle_chrystall
louise_frevert	louise_frevert
phil_mcdermott	phil_mcdermott
nina_toussaint-white	nina_toussaint-white
patrick_tam_(actor)	patrick_tam_(actor)
jack_lambert_(british_actor)	jack_lambert_(british_actor)
yuriko_hanabusa	yuriko_hanabusa
yan_yikuan	yan_yikuan
rachel_sternberg	rachel_sternberg
nikki_tyler	nikki_tyler
thomas_heathcote	thomas_heathcote
rino_higa	rino_higa
lisa_boyle	lisa_boyle
mihiro	mihiro
sasa_handa	sasa_handa
kerstin_tidelius	kerstin_tidelius
ikumi_hayama	ikumi_hayama
pat_keen	pat_keen
tory_mason	tory_mason
hannah_harper	hannah_harper
yuma_asami	yuma_asami
yoyo_mung	yoyo_mung
eloy_azorin	eloy_azorin
diana_magness	diana_magness
bryan_wong	bryan_wong
jeff_stryker	jeff_stryker
simon_quarterman	simon_quarterman
monica_chan	monica_chan
sally-jane_spencer	sally-jane_spencer
yvonne_lim	yvonne_lim
leila_tong	leila_tong
josephine_siao	josephine_siao
megan_pearson	megan_pearson
evelyn_tan	evelyn_tan
michael_culkin	michael_culkin
bridgette_kerkove	bridgette_kerkove
hollie_stevens	hollie_stevens
dorothy_foster	dorothy_foster
paul_venables	paul_venables
luo_jin	luo_jin
ane_dahl_torp	ane_dahl_torp
jacky_heung	jacky_heung
wayne_chua	wayne_chua
nigel_betts	nigel_betts
sture_ericson	sture_ericson
pip_carter	pip_carter
elliot_ngok	elliot_ngok
isao_yamagata	isao_yamagata
yoshihisa_kawahara	yoshihisa_kawahara
ernest_butcher	ernest_butcher
aya_suzaki	aya_suzaki
gertan_klauber	gertan_klauber
rina_hidaka	rina_hidaka
sayuri_uchida	sayuri_uchida
gwei_lun-mei	gwei_lun-mei
beverly_lynne	beverly_lynne
takaya_hashi	takaya_hashi
junji_takada	junji_takada
helen_ferrers	helen_ferrers
caroline_proust	caroline_proust
peter_schildt	peter_schildt
anita_rinaldi	anita_rinaldi
lai_lok-yi	lai_lok-yi
yurina_hase	yurina_hase
hayato_ichihara	hayato_ichihara
felicia_tang	felicia_tang
ikue_sakakibara	ikue_sakakibara
domonique_simone	domonique_simone
wang_gang_(actor)	wang_gang_(actor)
dagmar_olsson	dagmar_olsson
kimiko_matsuzaka	kimiko_matsuzaka
ron_heung	ron_heung
kenneth_kent	kenneth_kent
shayla_laveaux	shayla_laveaux
fujiko_takimoto	fujiko_takimoto
john_steiner	john_steiner
toby_sawyer	toby_sawyer
chi_chi_larue	chi_chi_larue
ang_ching_hui	ang_ching_hui
franklin_dyall	franklin_dyall
beans_balawi	beans_balawi
annalisa_ericson	annalisa_ericson
sonja_lund	sonja_lund
rachel_ryan	rachel_ryan
suzanne_mcbain	suzanne_mcbain
katsuni	katsuni
lisa_de_leeuw	lisa_de_leeuw
fiona_xie	fiona_xie
bonnie_rotten	bonnie_rotten
marie_wright	marie_wright
osamu_hosoi	osamu_hosoi
ginger_lynn	ginger_lynn
kazuki_namioka	kazuki_namioka
ran_ito	ran_ito
wallace_chung	wallace_chung
sophie_duniam	sophie_duniam
michael_rothwell_(actor)	michael_rothwell_(actor)
esme_hubbard	esme_hubbard
mary_dibley	mary_dibley
alex_sawyer	alex_sawyer
scott_o'hara	scott_o'hara
lily_carter	lily_carter
dallas_anderson_(actress)	dallas_anderson_(actress)
jason_chan_(singer)	jason_chan_(singer)
taeko_kawata	taeko_kawata
noel_leung	noel_leung
masahiro_kono	masahiro_kono
madeleine_renaud	madeleine_renaud
daisy_cakes	daisy_cakes
yuka_nishigaki	yuka_nishigaki
annica_smedius	annica_smedius
debbie_kurup	debbie_kurup
junko_miyashita	junko_miyashita
nick_patrick_(actor)	nick_patrick_(actor)
valerie_van_ost	valerie_van_ost
isabelle_mergault	isabelle_mergault
babben_larsson	babben_larsson
cecilia_gessa	cecilia_gessa
ayako_wakao	ayako_wakao
rosalind_shanks	rosalind_shanks
winifred_evans	winifred_evans
nici_sterling	nici_sterling
ray_dragon	ray_dragon
miyoko_asada	miyoko_asada
robert_baldwin_(actor)	robert_baldwin_(actor)
sumie_baba	sumie_baba
herbert_bunston	herbert_bunston
ittoku_kishibe	ittoku_kishibe
danny_green_(actor)	danny_green_(actor)
joanna_dunham	joanna_dunham
steven_farebrother	steven_farebrother
edward_lexy	edward_lexy
rachel_bell	rachel_bell
sharon_luk	sharon_luk
quan_yi_fong	quan_yi_fong
debbie_goh	debbie_goh
lawford_davidson	lawford_davidson
thammar_nazir	thammar_nazir
aileen_raymond	aileen_raymond
gianna_lynn	gianna_lynn
joey_silvera	joey_silvera
timmy_hung	timmy_hung
keisuke_koide	keisuke_koide
ha_yu_(actor)	ha_yu_(actor)
zhang_guoli	zhang_guoli
so_yamamura	so_yamamura
kent_tong	kent_tong
tristan_kingsley	tristan_kingsley
bailey_jay	bailey_jay
chen_daoming	chen_daoming
brenda_vaccaro	brenda_vaccaro
harold_kay	harold_kay
michela_miti	michela_miti
matt_gunther	matt_gunther
herbert_langley	herbert_langley
huang_bo	huang_bo
cyril_mclaglen	cyril_mclaglen
philippa_gail	philippa_gail
anna_lindholm	anna_lindholm
tomio_aoki	tomio_aoki
peter_swanwick	peter_swanwick
jamie_belman	jamie_belman
mai_haruna	mai_haruna
mikako_komatsu	mikako_komatsu
arnaud_collery	arnaud_collery
riko_tachibana	riko_tachibana
ellen_pollock	ellen_pollock
gillian_chung	gillian_chung
alistair_petrie	alistair_petrie
julie_strain	julie_strain
jennifer_white_shah	jennifer_white_shah
christian_xxx	christian_xxx
pierre_etchepare	pierre_etchepare
ichiro_sugai	ichiro_sugai
joe_junior	joe_junior
angelica_lee	angelica_lee
nicole_aniston	nicole_aniston
angela_down	angela_down
beverly_hills_(actress)	beverly_hills_(actress)
jo_kuk	jo_kuk
michel_galabru	michel_galabru
gloria_tapia	gloria_tapia
sydney_fairbrother	sydney_fairbrother
nils_hallberg	nils_hallberg
marie-christine_adam	marie-christine_adam
fred_wood_(actor)	fred_wood_(actor)
ken_ryker	ken_ryker
lysa_thatcher	lysa_thatcher
suzanna_dilber	suzanna_dilber
elof_ahrle	elof_ahrle
vincent_kok	vincent_kok
christian_j._frank	christian_j._frank
alyson_spiro	alyson_spiro
risa_junna	risa_junna
hiroya_matsumoto	hiroya_matsumoto
jasmine_byrne	jasmine_byrne
yoshiyuki_kono	yoshiyuki_kono
charlotte_lucas	charlotte_lucas
ray_coulthard	ray_coulthard
racquel_darrian	racquel_darrian
lila_leslie	lila_leslie
bertram_heribertson	bertram_heribertson
concordia_selander	concordia_selander
bai_baihe	bai_baihe
mike_morgan_(actor)	mike_morgan_(actor)
matthew_booth_(actor)	matthew_booth_(actor)
tsubasa_akimoto	tsubasa_akimoto
susan_stephen	susan_stephen
beverly_naya	beverly_naya
denise_coffey	denise_coffey
david_lloyd_meredith	david_lloyd_meredith
nils_eklund	nils_eklund
sven-eric_gamble	sven-eric_gamble
geff_francis	geff_francis
aileen_tan	aileen_tan
william_austin_(actor)	william_austin_(actor)
rebecca_saire	rebecca_saire
tomoko_akiya	tomoko_akiya
eleanor_summerfield	eleanor_summerfield
naoki_sugiura	naoki_sugiura
simon_de_la_brosse	simon_de_la_brosse
hugh_clifton	hugh_clifton
dominic_colenso	dominic_colenso
sami_frey	sami_frey
porsche_lynn	porsche_lynn
cole_youngblood	cole_youngblood
jack_stewart_(actor)	jack_stewart_(actor)
greta_almroth	greta_almroth
bertil_malmberg	bertil_malmberg
jeannie_carson	jeannie_carson
yukio_hashi	yukio_hashi
liu_ye_(actor)	liu_ye_(actor)
clifford_rose	clifford_rose
lord_tim_hudson	lord_tim_hudson
charles_rock	charles_rock
lexi_love	lexi_love
yu_nan	yu_nan
elizabeth_wallace_(actor)	elizabeth_wallace_(actor)
isabelle_nanty	isabelle_nanty
cole_tucker	cole_tucker
alien_sun	alien_sun
jennifer_rae_daykin	jennifer_rae_daykin
amber_kuo	amber_kuo
ingrid_backlin	ingrid_backlin
yoshiko_tanaka	yoshiko_tanaka
pai_ping-ping	pai_ping-ping
paul_chung	paul_chung
robert_urquhart_(actor)	robert_urquhart_(actor)
simeon_stuart	simeon_stuart
yuen_cheung-yan	yuen_cheung-yan
michel_drach	michel_drach
akiko_yada	akiko_yada
sayuri_yamauchi	sayuri_yamauchi
ed_powers	ed_powers
polly_duniam	polly_duniam
daiki_nakamura	daiki_nakamura
moustafa_chousein-oglou	moustafa_chousein-oglou
shiro_izumi	shiro_izumi
allanah_starr	allanah_starr
qin_lan	qin_lan
jenny_tomasin	jenny_tomasin
azusa_itagaki	azusa_itagaki
an_nanba	an_nanba
leanne_liu	leanne_liu
roxy_reynolds	roxy_reynolds
jonathan_morgan_(director)	jonathan_morgan_(director)
mitsuki_koga	mitsuki_koga
viola_compton	viola_compton
larisa_bakurova	larisa_bakurova
rosemarie_ford	rosemarie_ford
kate_tsui	kate_tsui
sam_chan	sam_chan
fumie_kusachi	fumie_kusachi
alfred_denville	alfred_denville
olof_sandborg	olof_sandborg
haruka_suenaga	haruka_suenaga
peter_collingwood	peter_collingwood
huggy_leaver	huggy_leaver
kjeld_gogosha-clark	kjeld_gogosha-clark
pierre_palau	pierre_palau
angie_cheong	angie_cheong
shay_jordan	shay_jordan
ariyon_bakare	ariyon_bakare
fernanda_marlowe	fernanda_marlowe
eliza_sam	eliza_sam
sydney_seaward	sydney_seaward
mario_montez	mario_montez
lena_t._hansson	lena_t._hansson
james_ryan_(actor)	james_ryan_(actor)
veronica_rayne	veronica_rayne
chow_yun-fat	chow_yun-fat
jun_mizusawa	jun_mizusawa
marc_de_jonge	marc_de_jonge
haruki_mizuno	haruki_mizuno
rosalind_halstead	rosalind_halstead
derek_gorst	derek_gorst
goro_ibuki	goro_ibuki
akane_tomonaga	akane_tomonaga
pip_torrens	pip_torrens
reine_brynolfsson	reine_brynolfsson
tetsuo_narikawa	tetsuo_narikawa
keiko_takahashi	keiko_takahashi
lina_ng	lina_ng
fleur_bennett	fleur_bennett
d._j._williams_(actor)	d._j._williams_(actor)
bunmi_mojekwu	bunmi_mojekwu
rebecca_egan	rebecca_egan
yoshiya_minami	yoshiya_minami
jun_murakami	jun_murakami
akira_sasanuma	akira_sasanuma
rei_dan	rei_dan
jean_mamy	jean_mamy
stephen_churchett	stephen_churchett
david_hutcheson	david_hutcheson
kazue_fukiishi	kazue_fukiishi
jean_boht	jean_boht
roger_blin	roger_blin
mao_miyaji	mao_miyaji
azusa_kataoka	azusa_kataoka
claire_duhamel	claire_duhamel
janne_carlsson	janne_carlsson
dai_xiangyu	dai_xiangyu
linda_chung	linda_chung
kenji_akabane	kenji_akabane
petra_nielsen	petra_nielsen
george_foley_(actor)	george_foley_(actor)
dystin_johnson	dystin_johnson
sam_kessel	sam_kessel
mariko_suzuki	mariko_suzuki
ann_trevor	ann_trevor
takehiro_murozono	takehiro_murozono
gaku_hamada	gaku_hamada
aimee_sweet	aimee_sweet
breanne_benson	breanne_benson
akaji_maro	akaji_maro
kelly_trump	kelly_trump
richard_divizio	richard_divizio
thomy_bourdelle	thomy_bourdelle
babette_bardot	babette_bardot
ayaka_yamashita	ayaka_yamashita
william_larsson	william_larsson
jacklyn_wu	jacklyn_wu
nicki_hunter	nicki_hunter
alice_patten	alice_patten
sora_ma	sora_ma
buck_adams	buck_adams
gina_hiraizumi	gina_hiraizumi
brian_pumper	brian_pumper
yukie_kawamura	yukie_kawamura
roger_maxwell_(actor)	roger_maxwell_(actor)
masashi_goda	masashi_goda
pippa_haywood	pippa_haywood
wong_jinglun	wong_jinglun
adia_chan	adia_chan
aletta_ocean	aletta_ocean
alana_evans	alana_evans
jonathan_coy	jonathan_coy
lyrian	lyrian
bo_brundin	bo_brundin
guo_degang	guo_degang
hugh_mitchell_(actor)	hugh_mitchell_(actor)
alex_to	alex_to
jimmy_nah	jimmy_nah
jade_leung	jade_leung
george_moon	george_moon
kim_chambers	kim_chambers
may_hallatt	may_hallatt
naho_toda	naho_toda
alicia_rhodes	alicia_rhodes
wu_ma	wu_ma
seka	seka
annica_risberg	annica_risberg
junya_ikeda	junya_ikeda
roy_chiao	roy_chiao
eiji_miyashita	eiji_miyashita
m.a._wetherell	m.a._wetherell
pat_simmons_(voice_actor)	pat_simmons_(voice_actor)
kento_nakajima	kento_nakajima
david_westhead	david_westhead
kelly_madison	kelly_madison
iemasa_kayumi	iemasa_kayumi
marcus_london	marcus_london
erik_hell	erik_hell
marlaine_gordon	marlaine_gordon
ryohei_odai	ryohei_odai
masaya_kato	masaya_kato
cui_peng_(actor)	cui_peng_(actor)
david_verrey	david_verrey
misayo_haruki	misayo_haruki
max_bacon_(actor)	max_bacon_(actor)
anna_palk	anna_palk
tristan_mathews	tristan_mathews
bleuette_bernon	bleuette_bernon
alan_ko	alan_ko
emily_fitzroy	emily_fitzroy
danny_d	danny_d
rebecca_zhu	rebecca_zhu
ruco_chan	ruco_chan
noriko_honma	noriko_honma
tetsushi_tanaka	tetsushi_tanaka
kumiko_nakano	kumiko_nakano
graham_pountney	graham_pountney
chingmy_yau	chingmy_yau
jia_hongsheng	jia_hongsheng
han_xue_(actress)	han_xue_(actress)
ron_ng	ron_ng
joyce_bland	joyce_bland
maggie_lau	maggie_lau
iain_mckee	iain_mckee
fred_rains	fred_rains
malin_berghagen	malin_berghagen
misty_stone	misty_stone
robert_moor	robert_moor
shelly_fujii	shelly_fujii
jane_welsh	jane_welsh
kaoru_kobayashi_(actor)	kaoru_kobayashi_(actor)
tim_matthews	tim_matthews
scott_sunderland_(actor)	scott_sunderland_(actor)
june_page	june_page
charles_bouillaud	charles_bouillaud
richard_dillane	richard_dillane
ricky_harun	ricky_harun
kei_mizutani	kei_mizutani
dion_lam	dion_lam
nozomi_takeuchi	nozomi_takeuchi
holly_mccall	holly_mccall
agda_helin	agda_helin
john_moulder-brown	john_moulder-brown
gordon_mcleod_(actor)	gordon_mcleod_(actor)
angela_chang	angela_chang
taylor_wane	taylor_wane
jason_chan_chi-san	jason_chan_chi-san
zeffie_tilbury	zeffie_tilbury
yumi_asou	yumi_asou
miles_fothergill	miles_fothergill
bunjaku_han	bunjaku_han
eriko_hara	eriko_hara
him_law	him_law
kwong_wa	kwong_wa
vincent_wong	vincent_wong
nicholas_burns_(actor)	nicholas_burns_(actor)
john_stagliano	john_stagliano
mona_seilitz	mona_seilitz
joanna_taylor	joanna_taylor
masako_sugaya	masako_sugaya
leslie_cheung	leslie_cheung
tim_dutton	tim_dutton
dennis_law_(film_director)	dennis_law_(film_director)
keiko_nakazawa	keiko_nakazawa
jacques_tarride	jacques_tarride
tera_wray	tera_wray
lois_baxter	lois_baxter
stan_shaw	stan_shaw
ricky_hui	ricky_hui
eva_henger	eva_henger
rosanne_wong	rosanne_wong
vahina_giocante	vahina_giocante
john_penrose_(actor)	john_penrose_(actor)
james_hillier_(actor)	james_hillier_(actor)
tora_teje	tora_teje
john_richardson_(actor)	john_richardson_(actor)
hiroko_suzuki_(voice_actress)	hiroko_suzuki_(voice_actress)
shu_watanabe_(actor)	shu_watanabe_(actor)
ko_chen-tung	ko_chen-tung
hitomi_hase	hitomi_hase
brittany_o'connell	brittany_o'connell
tomoko_yamaguchi	tomoko_yamaguchi
maria_darling	maria_darling
riria	riria
logan_mccree	logan_mccree
junko_shimakata	junko_shimakata
stacia_napierkowska	stacia_napierkowska
bobbi_eden	bobbi_eden
cristina_bella	cristina_bella
reiko_kusamura	reiko_kusamura
chad_knight	chad_knight
haley_paige	haley_paige
dominique_darel	dominique_darel
samuel_haus	samuel_haus
katie_kox	katie_kox
vincent_winter	vincent_winter
huang_yi_(actress)	huang_yi_(actress)
polly_emery	polly_emery
kokoro_amano	kokoro_amano
monique_demoan	monique_demoan
edward_atterton	edward_atterton
stephanie_che	stephanie_che
noriko_ohara	noriko_ohara
kenneth_tsang	kenneth_tsang
angela_mao	angela_mao
megumi_okina	megumi_okina
tony_tedeschi	tony_tedeschi
asako_fujii	asako_fujii
guy_bedos	guy_bedos
keith_buckley_(actor)	keith_buckley_(actor)
eleanor_matsuura	eleanor_matsuura
dave_hardman	dave_hardman
sibelle_hu	sibelle_hu
simon_slater	simon_slater
james_lloyd_(actor)	james_lloyd_(actor)
joseph_a._bennett	joseph_a._bennett
brian_cowan	brian_cowan
fanny_valette	fanny_valette
pierre_doris	pierre_doris
georgina_spelvin	georgina_spelvin
marcel_maupi	marcel_maupi
yuriko_hishimi	yuriko_hishimi
francine_brody	francine_brody
kasumi_suzuki	kasumi_suzuki
sayaka_kamiya	sayaka_kamiya
brian_poyser	brian_poyser
richard_caldicot	richard_caldicot
rikiya_yasuoka	rikiya_yasuoka
ann_morrish	ann_morrish
su_elliot	su_elliot
kazuki_shimizu	kazuki_shimizu
meguru_kosaka	meguru_kosaka
masanobu_takashima	masanobu_takashima
riley_reid	riley_reid
ayuri_konno	ayuri_konno
nicole_sheridan	nicole_sheridan
adabel_guerrero	adabel_guerrero
veronica_rose	veronica_rose
jennifer_veal	jennifer_veal
yasuo_iwata	yasuo_iwata
romeo_tan	romeo_tan
louis_cheung	louis_cheung
faith_brown	faith_brown
christopher_godwin	christopher_godwin
joanna_angel	joanna_angel
joey_yung	joey_yung
eason_chan	eason_chan
takaaki_ishibashi	takaaki_ishibashi
mick_ford	mick_ford
fernando_muylaert	fernando_muylaert
ron_bottitta	ron_bottitta
kaori_takahashi_(actress)	kaori_takahashi_(actress)
louis_koo	louis_koo
tavia_yeung	tavia_yeung
huang_biren	huang_biren
constance_song	constance_song
edgar_norfolk	edgar_norfolk
sunny_leone	sunny_leone
chihiro_otsuka	chihiro_otsuka
manning_whiley	manning_whiley
ross_adams	ross_adams
martin_walker_(actor)	martin_walker_(actor)
mana_sakura	mana_sakura
rosalyn_boulter	rosalyn_boulter
john_deverell	john_deverell
yoshikatsu_fujiki	yoshikatsu_fujiki
carole_ashby	carole_ashby
sharla_cheung	sharla_cheung
jordan_chan	jordan_chan
robert_vattier	robert_vattier
christa_theret	christa_theret
kylie_ireland	kylie_ireland
joseph_tozer	joseph_tozer
katsue_miwa	katsue_miwa
karl-arne_holmsten	karl-arne_holmsten
peter_harryson	peter_harryson
toshihide_wakamatsu	toshihide_wakamatsu
john_bryans	john_bryans
katsuji_mori	katsuji_mori
krista_ayne	krista_ayne
ngo_ka-nin	ngo_ka-nin
dan_milne	dan_milne
bill_amerson	bill_amerson
natasha_williams_(actress)	natasha_williams_(actress)
margaret_barton	margaret_barton
steven_st._croix	steven_st._croix
tyler_knight	tyler_knight
guy_marchand	guy_marchand
masato_harada	masato_harada
norah_gorsen	norah_gorsen
courtney_cummz	courtney_cummz
mr._pete	mr._pete
andrew_yuen	andrew_yuen
joni-ruth_white	joni-ruth_white
eva_lin	eva_lin
emi_kuroda	emi_kuroda
gustaf_molander	gustaf_molander
sun_honglei	sun_honglei
dennis_arundell	dennis_arundell
maurice_maillot	maurice_maillot
anita_west	anita_west
gull_natorp	gull_natorp
junko_okada	junko_okada
tang_pik-wan	tang_pik-wan
liu_xiao_ling_tong	liu_xiao_ling_tong
tina_yuzuki	tina_yuzuki
kazuko_shirakawa	kazuko_shirakawa
kenny_doughty	kenny_doughty
masakazu_tamura	masakazu_tamura
ruth_maitland	ruth_maitland
victor_travers	victor_travers
krysti_lynn	krysti_lynn
peter_denyer	peter_denyer
wallace_lupino	wallace_lupino
maruse_taro	maruse_taro
babita_pohoomull	babita_pohoomull
hu_jun	hu_jun
yukari_kokubun	yukari_kokubun
ann_marie_rios	ann_marie_rios
joey_leung	joey_leung
tariq_knight	tariq_knight
wong_tin-lam	wong_tin-lam
evergreen_mak_cheung-ching	evergreen_mak_cheung-ching
arisa_noto	arisa_noto
hugh_pryse	hugh_pryse
frederick_burtwell	frederick_burtwell
hajime_hana	hajime_hana
kei_marimura	kei_marimura
cavan_kendall	cavan_kendall
wang_yumei	wang_yumei
norman_ettlinger	norman_ettlinger
jay_ashley	jay_ashley
sachiko_hidari	sachiko_hidari
tetsu_shiratori	tetsu_shiratori
alexandra_pigg	alexandra_pigg
hideki_ogihara	hideki_ogihara
komaki_kurihara	komaki_kurihara
wei_zi	wei_zi
kym_ng	kym_ng
hans_wigren	hans_wigren
naomi_radcliffe	naomi_radcliffe
claude_faraldo	claude_faraldo
ian_paul_cassidy	ian_paul_cassidy
wee_kheng_ming	wee_kheng_ming
jessica_may	jessica_may
michiyo_nakajima	michiyo_nakajima
lally_bowers	lally_bowers
carl-axel_elfving	carl-axel_elfving
natasha_o'keeffe	natasha_o'keeffe
yuki_matsuzaki	yuki_matsuzaki
irma_christenson	irma_christenson
yuria_kato	yuria_kato
rex_o'malley	rex_o'malley
tucker_mcguire	tucker_mcguire
barbara_new	barbara_new
john_bentley_(actor)	john_bentley_(actor)
nicola_stephenson	nicola_stephenson
rebecca_chan	rebecca_chan
georges_staquet	georges_staquet
amanda_royle	amanda_royle
louis_emerick	louis_emerick
margaretha_krook	margaretha_krook
wyndham_guise	wyndham_guise
gaby_stenberg	gaby_stenberg
stuart_lindsell	stuart_lindsell
jimmy_godden	jimmy_godden
michael_gaunt	michael_gaunt
felecia	felecia
kenji_wu	kenji_wu
paul_moriarty_(actor)	paul_moriarty_(actor)
hidekazu_ichinose	hidekazu_ichinose
mark_womack_(british_actor)	mark_womack_(british_actor)
bibi_jones	bibi_jones
hitomi_hayasaka	hitomi_hayasaka
koreya_senda	koreya_senda
antonia_brough	antonia_brough
qiao_zhenyu	qiao_zhenyu
francis_lister	francis_lister
loni_sanders	loni_sanders
jean_daurand	jean_daurand
vanessa_blue	vanessa_blue
helge_hagerman	helge_hagerman
samir_boitard	samir_boitard
ava_rose	ava_rose
lea_de_mae	lea_de_mae
jeremy_wilkin	jeremy_wilkin
nobuyuki_kobushi	nobuyuki_kobushi
kazuo_funaki	kazuo_funaki
kenneth_kove	kenneth_kove
qi_yuwu	qi_yuwu
julian_bleach	julian_bleach
etsushi_toyokawa	etsushi_toyokawa
jason_ridge	jason_ridge
abel_jacquin	abel_jacquin
frank_cochrane	frank_cochrane
yuriko_ishida	yuriko_ishida
dillon_day	dillon_day
samuel_colt_(actor)	samuel_colt_(actor)
celia_gregory	celia_gregory
akiko_matsumoto	akiko_matsumoto
sharon_byatt	sharon_byatt
chrissie_white	chrissie_white
kiwako_taichi	kiwako_taichi
lena_brogren	lena_brogren
stacey_cadman	stacey_cadman
ben_field	ben_field
harry_stott	harry_stott
sayuri_sadaoka	sayuri_sadaoka
fujiko_(actress)	fujiko_(actress)
jesse_jane	jesse_jane
masaya_kikawada	masaya_kikawada
mai_tachihara	mai_tachihara
rosanna_carter	rosanna_carter
jacqueline_sassard	jacqueline_sassard
simone_griffeth	simone_griffeth
hans_lindgren	hans_lindgren
ben_peyton	ben_peyton
bridget_powers	bridget_powers
jessica_brooks	jessica_brooks
steve_halliwell	steve_halliwell
colin_spaull	colin_spaull
vivien_yeo	vivien_yeo
hikaru_yamamoto	hikaru_yamamoto
matthew_beard_(british_actor)	matthew_beard_(british_actor)
xu_zheng_(actor)	xu_zheng_(actor)
corinna_chamberlain	corinna_chamberlain
isabelle_sadoyan	isabelle_sadoyan
jeff_barlow	jeff_barlow
nina_sevening	nina_sevening
ona_zee	ona_zee
gary_myers_(actor)	gary_myers_(actor)
jessie_rogers	jessie_rogers
john_turnbull_(actor)	john_turnbull_(actor)
melissa-ashley	melissa-ashley
colin_edwynn	colin_edwynn
asia_carrera	asia_carrera
keaton_yamada	keaton_yamada
margaret_lee_(singaporean_actress)	margaret_lee_(singaporean_actress)
kim_tiddy	kim_tiddy
victoria_zdrok	victoria_zdrok
jane_marken	jane_marken
nagisa_katahira	nagisa_katahira
madeleine_sologne	madeleine_sologne
filip_berg	filip_berg
presley_hart	presley_hart
taylor_st._claire	taylor_st._claire
isa_quensel	isa_quensel
moo_yan_yee	moo_yan_yee
sam_phillips_(model)	sam_phillips_(model)
bertram_burleigh	bertram_burleigh
hiroyuki_ikeuchi	hiroyuki_ikeuchi
tony_rohr	tony_rohr
michiko_godai	michiko_godai
puma_swede	puma_swede
benjamin_beresford	benjamin_beresford
selen	selen
yorie_terauchi	yorie_terauchi
george_barraud	george_barraud
lorraine_hilton	lorraine_hilton
hiroshi_naka	hiroshi_naka
manuel_ferrara	manuel_ferrara
jeanette_sterke	jeanette_sterke
mai_hoshikawa	mai_hoshikawa
lynn_lemay	lynn_lemay
mark_dymond	mark_dymond
corinne_alphen	corinne_alphen
kee_thuan_chye	kee_thuan_chye
rie_kanda	rie_kanda
hou_yong_(actor)	hou_yong_(actor)
juno_mak	juno_mak
david_brett	david_brett
susan_cruse	susan_cruse
yuen_biao	yuen_biao
tsutomu_kitagawa	tsutomu_kitagawa
douglas_muir_(actor)	douglas_muir_(actor)
edward_ou	edward_ou
kayden_kross	kayden_kross
sam_lee_(actor)	sam_lee_(actor)
derek_farr	derek_farr
adriana_sage	adriana_sage
bartlett_mullins	bartlett_mullins
michelle_goh	michelle_goh
kimito_totani	kimito_totani
kiichi_nakai	kiichi_nakai
jackie_sardou	jackie_sardou
fredrik_ohlsson	fredrik_ohlsson
lloyd_pearson	lloyd_pearson
tae_hitoto	tae_hitoto
chen_zihan	chen_zihan
daniel_coonan	daniel_coonan
jukichi_uno	jukichi_uno
mayumi_wakamura	mayumi_wakamura
mary_porter_(actress)	mary_porter_(actress)
rolf_holmgren	rolf_holmgren
david_siu	david_siu
colton_ford	colton_ford
blake_palmer	blake_palmer
richard_ainley	richard_ainley
ola_rapace	ola_rapace
abi_eniola	abi_eniola
aya_sugimoto	aya_sugimoto
arne_lindblad	arne_lindblad
cameron_marshall	cameron_marshall
hayley_carmichael	hayley_carmichael
jerry_yan	jerry_yan
yoshiko_kuga	yoshiko_kuga
bonnie_holiday	bonnie_holiday
kazutoshi_hatano	kazutoshi_hatano
gunilla_nyroos	gunilla_nyroos
gina_lynn	gina_lynn
edison_chen	edison_chen
nene_otsuka	nene_otsuka
peggy_novak	peggy_novak
chen_yunshang	chen_yunshang
raymond_lam	raymond_lam
cheuk_wan-chi	cheuk_wan-chi
margaret_withers	margaret_withers
elsie_albiin	elsie_albiin
yoshifumi_tajima	yoshifumi_tajima
sunday_wilshin	sunday_wilshin
ethan_juan	ethan_juan
ken_chu	ken_chu
taiten_kusunoki	taiten_kusunoki
shiori_mikami	shiori_mikami
babar_bhatti	babar_bhatti
jesse_santana	jesse_santana
geoffrey_streatfeild	geoffrey_streatfeild
gunilla_olsson	gunilla_olsson
choc7	choc7
nobuaki_sekine	nobuaki_sekine
karina_nose	karina_nose
alec_fraser	alec_fraser
shiho_kawaragi	shiho_kawaragi
noriko_eguchi	noriko_eguchi
russell_wong	russell_wong
gabriel_alw	gabriel_alw
john_hanson_(singer)	john_hanson_(singer)
claude_titre	claude_titre
isabelle_amyes	isabelle_amyes
frances_tomelty	frances_tomelty
bob_haymes	bob_haymes
eddie_axberg	eddie_axberg
maya_okamoto	maya_okamoto
zhang_fengyi	zhang_fengyi
alan_stafford	alan_stafford
per-axel_arosenius	per-axel_arosenius
shyla_foxxx	shyla_foxxx
albert_dupontel	albert_dupontel
hedli_anderson	hedli_anderson
jacqueline_king	jacqueline_king
rainie_yang	rainie_yang
marguerite_allan	marguerite_allan
jerry_yeo	jerry_yeo
robin_langford	robin_langford
dorris_bowdon	dorris_bowdon
kei_suma	kei_suma
jean-claude_michel	jean-claude_michel
li_shing-cheong	li_shing-cheong
bernard_blier	bernard_blier
nikki_jayne	nikki_jayne
kento_kaku	kento_kaku
marc_chapiteau	marc_chapiteau
anneli_alhanko	anneli_alhanko
courtney_phillips	courtney_phillips
stacey_tendeter	stacey_tendeter
denise_perrier	denise_perrier
natasha_kiss	natasha_kiss
yudai_chiba	yudai_chiba
jun_hamamura	jun_hamamura
george_a._cooper	george_a._cooper
stanley_lebor	stanley_lebor
dodo_watts	dodo_watts
jeanne_stuart	jeanne_stuart
owodog	owodog
omi_minami	omi_minami
philip_hewland	philip_hewland
tong_dawei	tong_dawei
charlie_hall_(actor)	charlie_hall_(actor)
don_stannard	don_stannard
april_flowers	april_flowers
gong_li	gong_li
dennis_to	dennis_to
raquel_devine	raquel_devine
kanako_mitsuhashi	kanako_mitsuhashi
gloria_yip	gloria_yip
kary_ng	kary_ng
john_nettleton_(actor)	john_nettleton_(actor)
heather_james	heather_james
brook_williams	brook_williams
johan_ulveson	johan_ulveson
hubert_gregg	hubert_gregg
angel_kelly	angel_kelly
raymond_dandy	raymond_dandy
pang_ho-cheung	pang_ho-cheung
eva_funck	eva_funck
shane_pow	shane_pow
reginald_bach	reginald_bach
william_miller_(actor)	william_miller_(actor)
mari_possa	mari_possa
annie_sprinkle	annie_sprinkle
paul_jesson	paul_jesson
takeru_shibaki	takeru_shibaki
robert_hirsch_(actor)	robert_hirsch_(actor)
kazunari_kojima	kazunari_kojima
hisayoshi_suganuma	hisayoshi_suganuma
clare_burt	clare_burt
roman_heart	roman_heart
sammy_leung	sammy_leung
daisuke_nakamura	daisuke_nakamura
reina_triendl	reina_triendl
daniel_emilfork	daniel_emilfork
yuka_nomura	yuka_nomura
satoshi_goto	satoshi_goto
princess_donna	princess_donna
frederic_abbott	frederic_abbott
mary_saunderson	mary_saunderson
alain_cuny	alain_cuny
troy_titus-adams	troy_titus-adams
aya_ishizu	aya_ishizu
nina_kumagaya	nina_kumagaya
huo_siyan	huo_siyan
nils_moritz	nils_moritz
suzanne_collins_(actress)	suzanne_collins_(actress)
pauline_johnson_(actress)	pauline_johnson_(actress)
judy_holt	judy_holt
hollie-jay_bowes	hollie-jay_bowes
tom_busby	tom_busby
danson_tang	danson_tang
lil_terselius	lil_terselius
johnny_hazzard	johnny_hazzard
louis_hurtaut_dancourt	louis_hurtaut_dancourt
trinity_loren	trinity_loren
kate_colgrave_pope	kate_colgrave_pope
pia_degermark	pia_degermark
edvard_persson	edvard_persson
tony_d'amario	tony_d'amario
masashi_mikami	masashi_mikami
jan-olof_strandberg	jan-olof_strandberg
blanche_ravalec	blanche_ravalec
james_deen	james_deen
tomiko_suzuki	tomiko_suzuki
rolla_norman	rolla_norman
billy_herrington	billy_herrington
ray_trickett	ray_trickett
freya_wilson	freya_wilson
cherie_chung	cherie_chung
jessica_liedberg	jessica_liedberg
douglas_simmonds	douglas_simmonds
norman_evans	norman_evans
tina_cheri	tina_cheri
marta_romero	marta_romero
sharon_chan	sharon_chan
cecil_mannering	cecil_mannering
steven_cheung_(actor)	steven_cheung_(actor)
kaede_matsushima	kaede_matsushima
chiu_chi-ling	chiu_chi-ling
michel_auclair	michel_auclair
sophie_cook	sophie_cook
nikky_blond	nikky_blond
stacey_donovan	stacey_donovan
lee_sheung-ching	lee_sheung-ching
helen_rowland_(actress)	helen_rowland_(actress)
reen_yu	reen_yu
zhang_jin	zhang_jin
marie-france_mignal	marie-france_mignal
keiko_oginome	keiko_oginome
huang_wenyong	huang_wenyong
shirin_taylor	shirin_taylor
karen_mok	karen_mok
faye_wong	faye_wong
anita_mui	anita_mui
robert_hartley	robert_hartley
dylan_ryan	dylan_ryan
li_yuchun	li_yuchun
roger_kwok	roger_kwok
john_witty	john_witty
adolf_jahr	adolf_jahr
rob_rotten	rob_rotten
mark_lui	mark_lui
peter_penry-jones	peter_penry-jones
amile_waters	amile_waters
matthew_ko	matthew_ko
sadako_sawamura	sadako_sawamura
kayo_matsuo	kayo_matsuo
chihiro_hara	chihiro_hara
tomoka_kurotani	tomoka_kurotani
naoko_kouda	naoko_kouda
laura_petela	laura_petela
wanda_kosakiewicz	wanda_kosakiewicz
jean_le_poulain	jean_le_poulain
rex_davis	rex_davis
qin_yi	qin_yi
kira_kener	kira_kener
roddy_maude-roxby	roddy_maude-roxby
jade_ramsey	jade_ramsey
nobunaga_shimazaki	nobunaga_shimazaki
hal_osmond	hal_osmond
kendra_jade_rossi	kendra_jade_rossi
andy_on	andy_on
norah_howard	norah_howard
mei_kurokawa	mei_kurokawa
hassei_takano	hassei_takano
joe_jacobs_(actor)	joe_jacobs_(actor)
kaori_(voice_actress)	kaori_(voice_actress)
carly_hillman	carly_hillman
jay_chou	jay_chou
richard_lintern	richard_lintern
li_lingyu	li_lingyu
kevin_brennan_(actor)	kevin_brennan_(actor)
tera_patrick	tera_patrick
jinpachi_nezu	jinpachi_nezu
ryan_gage	ryan_gage
david_horovitch	david_horovitch
julie_cox	julie_cox
maggie_cheung	maggie_cheung
sven_holmberg	sven_holmberg
sally_rogers	sally_rogers
linzi_drew	linzi_drew
julia_ford	julia_ford
elizabeth_adare	elizabeth_adare
sandra_payne	sandra_payne
terri_kwan	terri_kwan
amanda_hillwood	amanda_hillwood
winston_chao	winston_chao
yasufumi_terawaki	yasufumi_terawaki
emmanuel_mouret	emmanuel_mouret
hou_hsiao-hsien	hou_hsiao-hsien
colette_ripert	colette_ripert
derek_kok	derek_kok
wong_li-lin	wong_li-lin
rita_faltoyano	rita_faltoyano
michele_austin	michele_austin
aftab_sachak	aftab_sachak
rumiko_ukai	rumiko_ukai
madoka_yonezawa	madoka_yonezawa
brian_tse_(singer)	brian_tse_(singer)
carolin_stoltz	carolin_stoltz
stephen_mcgann	stephen_mcgann
cathryn_bradshaw	cathryn_bradshaw
olle_hilding	olle_hilding
miki_mizuasa	miki_mizuasa
karen_ascoe	karen_ascoe
chesty_morgan	chesty_morgan
vivian_lai	vivian_lai
anders_henrikson	anders_henrikson
masayuki_mori_(actor)	masayuki_mori_(actor)
machiko_washio	machiko_washio
jacques_mathou	jacques_mathou
raymond_francis	raymond_francis
cyndi_wang	cyndi_wang
kazuko_yanaga	kazuko_yanaga
nyomi_banxxx	nyomi_banxxx
jonathon_morris	jonathon_morris
ronald_ward	ronald_ward
frej_lindqvist	frej_lindqvist
kazue_komiya	kazue_komiya
m._gray_murray	m._gray_murray
yam_kim-fai	yam_kim-fai
cheung_tat-ming	cheung_tat-ming
lars_ekborg	lars_ekborg
ty_lattimore	ty_lattimore
miki_sugimoto	miki_sugimoto
hidemi_anzai	hidemi_anzai
lo_mang	lo_mang
lux_kassidy	lux_kassidy
jack_kao	jack_kao
nicholas_selby	nicholas_selby
mew_azama	mew_azama
peter_dalle	peter_dalle
raghu_babu	raghu_babu
sayoko_hagiwara	sayoko_hagiwara
gabriella_hall	gabriella_hall
debby_bishop	debby_bishop
kaoru_fujino	kaoru_fujino
cindy_leadbetter	cindy_leadbetter
torgny_anderberg	torgny_anderberg
megu_fujiura	megu_fujiura
marie_ault	marie_ault
michael_wildman	michael_wildman
gabriela_rivero	gabriela_rivero
sara_tommasi	sara_tommasi
sandra_ng	sandra_ng
georg_adelly	georg_adelly
kate_pang	kate_pang
isidor_torkar	isidor_torkar
alfred_travers	alfred_travers
pierre_palmade	pierre_palmade
hisako_manda	hisako_manda
adam_gillen	adam_gillen
patricia_plunkett	patricia_plunkett
bai_ling	bai_ling
harumi_ikoma	harumi_ikoma
fumie_hosokawa	fumie_hosokawa
jacques_pills	jacques_pills
naomi_zaizen	naomi_zaizen
mari_mashiba	mari_mashiba
peggy_evans	peggy_evans
roy_emerton	roy_emerton
sophie_bould	sophie_bould
christopher_naylor_(actor)	christopher_naylor_(actor)
yasunori_masutani	yasunori_masutani
yuri_yamaoka	yuri_yamaoka
eric_christmas	eric_christmas
chasey_lain	chasey_lain
hikari_hino	hikari_hino
mitsuko_mori	mitsuko_mori
silvia_navarro	silvia_navarro
zhang_ruifang	zhang_ruifang
naoki_yanagi	naoki_yanagi
wylie_watson	wylie_watson
olive_mercer	olive_mercer
alexander_tolstoy	alexander_tolstoy
eri_ishida	eri_ishida
caroline_lee-johnson	caroline_lee-johnson
henry_thia	henry_thia
rayveness	rayveness
jacques_boudet	jacques_boudet
clive_morton	clive_morton
yoyo_chen	yoyo_chen
zhang_lei_(actor)	zhang_lei_(actor)
gerald_fielding	gerald_fielding
joseph_chang	joseph_chang
marc_barrow	marc_barrow
rio_natsuki	rio_natsuki
sharon_kao	sharon_kao
tiffany_clark	tiffany_clark
harry_s._morgan	harry_s._morgan
michael_wong_(actor)	michael_wong_(actor)
olivier_marchal	olivier_marchal
philip_fox_(actor)	philip_fox_(actor)
nicolas_bedos	nicolas_bedos
miwa_matsumoto	miwa_matsumoto
ayumi_beppu	ayumi_beppu
race_davies	race_davies
peter_ho	peter_ho
carmen_chaplin	carmen_chaplin
teresa_cheung_(actress)	teresa_cheung_(actress)
nozomi_yamamoto	nozomi_yamamoto
david_chiang	david_chiang
sheila_raynor	sheila_raynor
tori_welles	tori_welles
katherine_east	katherine_east
aurora_snow	aurora_snow
paul_faivre	paul_faivre
misa_uehara_(actress,_born_1937)	misa_uehara_(actress,_born_1937)
pierre_michael	pierre_michael
stephen_au	stephen_au
katsunosuke_hori	katsunosuke_hori
yoshiko_asai	yoshiko_asai
gary_powell_(actor)	gary_powell_(actor)
james_culliford	james_culliford
dominic_lam	dominic_lam
robert_hudson_(actor)	robert_hudson_(actor)
steven_o'donnell_(actor)	steven_o'donnell_(actor)
barry_mackay_(actor)	barry_mackay_(actor)
essy_persson	essy_persson
alisha_klass	alisha_klass
austin_leigh	austin_leigh
cameron_jackson	cameron_jackson
kerry_berry_brogan	kerry_berry_brogan
reese_rideout	reese_rideout
takako_katou	takako_katou
eric_tsang	eric_tsang
bambi_woods	bambi_woods
lesley_brook	lesley_brook
connie_hyde	connie_hyde
noriko_higashide	noriko_higashide
mia_naruse	mia_naruse
heron_carvic	heron_carvic
theresa_lee	theresa_lee
yukiko_takaguchi	yukiko_takaguchi
sharon_thorpe	sharon_thorpe
megan_lai	megan_lai
thomas_ho_(actor)	thomas_ho_(actor)
zen_chong	zen_chong
yan_ni	yan_ni
zhou_ying_(actress)	zhou_ying_(actress)
joyce_tang	joyce_tang
takeshi_watabe	takeshi_watabe
maria_yumeno	maria_yumeno
roxane_duran	roxane_duran
marcelle_praince	marcelle_praince
agneta_ekmanner	agneta_ekmanner
heather_hunter	heather_hunter
savanna_samson	savanna_samson
viviane_brunieri	viviane_brunieri
darry_cowl	darry_cowl
kylie_babbington	kylie_babbington
