uganda_museum	uganda_museum
exploration_place	exploration_place
rembrandt_house_museum	rembrandt_house_museum
vatican_museums	vatican_museums
oulu_museum_of_art	oulu_museum_of_art
weisman_art_museum	weisman_art_museum
dorman_museum	dorman_museum
nikola_tesla_museum	nikola_tesla_museum
kyoto_international_manga_museum	kyoto_international_manga_museum
chiwoo_craft_museum	chiwoo_craft_museum
australian_national_maritime_museum	australian_national_maritime_museum
san_francisco_museum_of_modern_art	san_francisco_museum_of_modern_art
finnish_aviation_museum	finnish_aviation_museum
hungarian_national_gallery	hungarian_national_gallery
virasat-e-khalsa	virasat-e-khalsa
herschel_museum_of_astronomy	herschel_museum_of_astronomy
museum_boijmans_van_beuningen	museum_boijmans_van_beuningen
jurby_transport_museum	jurby_transport_museum
museum_aan_de_stroom	museum_aan_de_stroom
seoul_museum_of_history	seoul_museum_of_history
national_gallery_in_prague	national_gallery_in_prague
wereldmuseum	wereldmuseum
marian_koshland_science_museum	marian_koshland_science_museum
aviation_museum_of_central_finland	aviation_museum_of_central_finland
chojun_textile_&_quilt_art_museum	chojun_textile_&_quilt_art_museum
cartoon_art_museum	cartoon_art_museum
belgian_comic_strip_center	belgian_comic_strip_center
house_of_terror	house_of_terror
walk_of_the_stars	walk_of_the_stars
montreal_planetarium	montreal_planetarium
lithuanian_road_museum	lithuanian_road_museum
carnegie_science_center	carnegie_science_center
bata_shoe_museum	bata_shoe_museum
shanghai_urban_planning_exhibition_center	shanghai_urban_planning_exhibition_center
freud_museum	freud_museum
children's_museum_of_los_angeles	children's_museum_of_los_angeles
danmarks_traktormuseum	danmarks_traktormuseum
racine_art_museum	racine_art_museum
valencia_history_museum	valencia_history_museum
kiasma	kiasma
wally_parks_nhra_motorsports_museum	wally_parks_nhra_motorsports_museum
global_village_folk_museum	global_village_folk_museum
north_carolina_museum_of_history	north_carolina_museum_of_history
amsterdam_museum	amsterdam_museum
adam_art_gallery	adam_art_gallery
dharma_wiratama_museum	dharma_wiratama_museum
national_museum_of_the_pacific_war	national_museum_of_the_pacific_war
estonian_maritime_museum	estonian_maritime_museum
museu_militar_do_porto	museu_militar_do_porto
singapore_city_gallery	singapore_city_gallery
mccord_museum	mccord_museum
crystal_bridges_museum_of_american_art	crystal_bridges_museum_of_american_art
getty_center	getty_center
savina_museum	savina_museum
museum_of_asian_art	museum_of_asian_art
alameda_museum	alameda_museum
rio_tinto_alcan_planetarium	rio_tinto_alcan_planetarium
chabot_museum	chabot_museum
moundville_archaeological_museum	moundville_archaeological_museum
american_folk_art_museum	american_folk_art_museum
national_press_monument	national_press_monument
national_museum_of_ireland	national_museum_of_ireland
lyallpur_museum	lyallpur_museum
museum_folkwang	museum_folkwang
aga_khan_museum	aga_khan_museum
ulsan_museum	ulsan_museum
riverside_museum_at_blake's_lock	riverside_museum_at_blake's_lock
bologna_museum_of_modern_art	bologna_museum_of_modern_art
ulsan_science_museum	ulsan_science_museum
museo_soumaya	museo_soumaya
99s_museum_of_women_pilots	99s_museum_of_women_pilots
yiddish_book_center	yiddish_book_center
art_museum_of_southeast_texas	art_museum_of_southeast_texas
diamond_museum_amsterdam	diamond_museum_amsterdam
strataca	strataca
bank_mandiri_museum	bank_mandiri_museum
museum_of_diplomatic_corps	museum_of_diplomatic_corps
bank_of_korea_museum	bank_of_korea_museum
rodin_museum	rodin_museum
war_of_independence_museum	war_of_independence_museum
national_postal_museum	national_postal_museum
georgia_music_hall_of_fame	georgia_music_hall_of_fame
sanskar_kendra	sanskar_kendra
seoul_education_museum	seoul_education_museum
seaplane_harbour	seaplane_harbour
american_museum_of_magic	american_museum_of_magic
henry_art_gallery	henry_art_gallery
telus_spark	telus_spark
setagaya_art_museum	setagaya_art_museum
scitrek	scitrek
hellfire_pass	hellfire_pass
adana_cinema_museum	adana_cinema_museum
oshawa_community_museum	oshawa_community_museum
st._augustine_pirate_&_treasure_museum	st._augustine_pirate_&_treasure_museum
science_north	science_north
hash,_marihuana_&_hemp_museum	hash,_marihuana_&_hemp_museum
tri-state_warbird_museum	tri-state_warbird_museum
fantasy_of_flight	fantasy_of_flight
melbourne's_living_museum_of_the_west	melbourne's_living_museum_of_the_west
ogden_museum_of_southern_art	ogden_museum_of_southern_art
national_gallery_of_indonesia	national_gallery_of_indonesia
ukraine_state_aviation_museum	ukraine_state_aviation_museum
children's_museum_of_winston-salem	children's_museum_of_winston-salem
estonian_history_museum	estonian_history_museum
beaumont_art_league	beaumont_art_league
guba_genocide_memorial_complex	guba_genocide_memorial_complex
captain_cook_birthplace_museum	captain_cook_birthplace_museum
van_gogh_museum	van_gogh_museum
presseum	presseum
west_berkshire_museum	west_berkshire_museum
fraunces_tavern	fraunces_tavern
harley-davidson_museum	harley-davidson_museum
beijing_planning_exhibition_hall	beijing_planning_exhibition_hall
niles_depot_museum	niles_depot_museum
gilmore_car_museum	gilmore_car_museum
american_university_museum	american_university_museum
balay_negrense	balay_negrense
neka_art_museum	neka_art_museum
museum_of_occupations	museum_of_occupations
national_museum_of_bhutan	national_museum_of_bhutan
booth_museum_of_natural_history	booth_museum_of_natural_history
museum_of_the_image	museum_of_the_image
baku_museum_of_modern_art	baku_museum_of_modern_art
the_science_factory	the_science_factory
toonseum	toonseum
creation_museum	creation_museum
rieskrater_museum	rieskrater_museum
escher_museum	escher_museum
raahe_museum	raahe_museum
guggenheim_museum_bilbao	guggenheim_museum_bilbao
bach_house_(eisenach)	bach_house_(eisenach)
istanbul_archaeology_museums	istanbul_archaeology_museums
cinquantenaire_museum	cinquantenaire_museum
kyushu_national_museum	kyushu_national_museum
cosmodome	cosmodome
cardiff_story	cardiff_story
silent_wings_museum	silent_wings_museum
netherlands_architecture_institute	netherlands_architecture_institute
house-museum_of_vagif_mustafazadeh	house-museum_of_vagif_mustafazadeh
hockey_heritage_north	hockey_heritage_north
drents_museum	drents_museum
independence_museum_of_azerbaijan	independence_museum_of_azerbaijan
sainte_marie_among_the_iroquois	sainte_marie_among_the_iroquois
jean_cocteau_museum	jean_cocteau_museum
pakistan_army_museum	pakistan_army_museum
trabzon_museum	trabzon_museum
national_museum_of_the_united_states_air_force	national_museum_of_the_united_states_air_force
mcwane_science_center	mcwane_science_center
national_sports_museum	national_sports_museum
galileo_galilei_planetarium	galileo_galilei_planetarium
australian_railway_historical_society_museum	australian_railway_historical_society_museum
allard_pierson_museum	allard_pierson_museum
national_museum_of_sudan	national_museum_of_sudan
kimbell_art_museum	kimbell_art_museum
rakkojae	rakkojae
korean_revolution_museum	korean_revolution_museum
museo_universitario_del_chopo	museo_universitario_del_chopo
york_art_gallery	york_art_gallery
la_maison_de_la_magie_robert-houdin	la_maison_de_la_magie_robert-houdin
museum_perumusan_naskah_proklamasi	museum_perumusan_naskah_proklamasi
hout_bay_museum	hout_bay_museum
pendine_museum_of_speed	pendine_museum_of_speed
honda_collection_hall	honda_collection_hall
modoc_county_historical_museum	modoc_county_historical_museum
wadsworth_atheneum	wadsworth_atheneum
odessa_art_museum	odessa_art_museum
museum_de_oude_wolden	museum_de_oude_wolden
lithuanian_museum_of_ethnocosmology	lithuanian_museum_of_ethnocosmology
rubin_museum_of_art	rubin_museum_of_art
gasworks_gallery	gasworks_gallery
museo_alameda	museo_alameda
tampa_bay_automobile_museum	tampa_bay_automobile_museum
radya_pustaka_museum	radya_pustaka_museum
reflections_at_bukit_chandu	reflections_at_bukit_chandu
new_york_transit_museum	new_york_transit_museum
vero_beach_museum_of_art	vero_beach_museum_of_art
tartu_toy_museum	tartu_toy_museum
nichols_arboretum	nichols_arboretum
cwow_gallery	cwow_gallery
shania_twain_centre	shania_twain_centre
tate_britain	tate_britain
international_museum_of_horology	international_museum_of_horology
national_museum_of_crime_&_punishment	national_museum_of_crime_&_punishment
national_constitution_center	national_constitution_center
the_cloisters	the_cloisters
bechtler_museum_of_modern_art	bechtler_museum_of_modern_art
abingdon_county_hall_museum	abingdon_county_hall_museum
british_commercial_vehicle_museum	british_commercial_vehicle_museum
belvue_museum	belvue_museum
rockefeller_museum	rockefeller_museum
foosaner_art_museum	foosaner_art_museum
