george_dewhurst	george_dewhurst
tabatha_cash	tabatha_cash
bruce_lee	bruce_lee
harry_fielder	harry_fielder
christian_casadesus	christian_casadesus
connie_chan	connie_chan
michael_miu	michael_miu
leanne_li	leanne_li
ulf_palme	ulf_palme
lawson_butt	lawson_butt
shauna_o'brien	shauna_o'brien
sam_livesey	sam_livesey
feng_gong	feng_gong
jean_coquelin	jean_coquelin
hiroyuki_onoue	hiroyuki_onoue
alice_tzeng	alice_tzeng
risa_coda	risa_coda
he_saifei	he_saifei
anna_calder-marshall	anna_calder-marshall
nikolai_kinski	nikolai_kinski
min_tanaka	min_tanaka
yutaka_matsushige	yutaka_matsushige
masato_yamanouchi	masato_yamanouchi
jack_livesey	jack_livesey
nelson_keys	nelson_keys
chang_chen	chang_chen
mark_lee_(comedian)	mark_lee_(comedian)
ivo_dawson	ivo_dawson
curt_masreliez	curt_masreliez
ann-marie_gyllenspetz	ann-marie_gyllenspetz
colin_keith-johnston	colin_keith-johnston
brett_mycles	brett_mycles
brandy_talore	brandy_talore
jean_bradin	jean_bradin
rio_mariah	rio_mariah
stefan_wong_(actor)	stefan_wong_(actor)
victor_huang	victor_huang
daniel_duval	daniel_duval
griffith_jones_(actor)	griffith_jones_(actor)
eriko_watanabe	eriko_watanabe
walter_byron_(actor)	walter_byron_(actor)
gilly_coman	gilly_coman
shanna_mccullough	shanna_mccullough
martin_boddey	martin_boddey
hideo_kanze	hideo_kanze
belladonna_(actress)	belladonna_(actress)
john_shum	john_shum
dagmar_ebbesen	dagmar_ebbesen
waise_lee	waise_lee
hidetoshi_nishijima_(actor)	hidetoshi_nishijima_(actor)
bramwell_fletcher	bramwell_fletcher
guy_bellis	guy_bellis
philip_ray	philip_ray
brooke_ashley	brooke_ashley
stephy_tang	stephy_tang
hotaru_akane	hotaru_akane
norman_wooland	norman_wooland
kurt_lockwood	kurt_lockwood
marika_green	marika_green
kelly_divine	kelly_divine
geoffrey_beevers	geoffrey_beevers
chad_hunt	chad_hunt
terence_cooper	terence_cooper
daniel_wu	daniel_wu
sammul_chan	sammul_chan
kent_riley	kent_riley
hal_gordon	hal_gordon
emily_chu	emily_chu
linda_armstrong	linda_armstrong
selena_li	selena_li
hikaru_koto	hikaru_koto
leena_la_bianca	leena_la_bianca
nikki_dial	nikki_dial
philip_latham	philip_latham
marjorie_monaghan	marjorie_monaghan
nadia_barentin	nadia_barentin
jack_purvis_(actor)	jack_purvis_(actor)
ulf_johanson	ulf_johanson
lee_kang-sheng	lee_kang-sheng
he_meitian	he_meitian
ivy_duke	ivy_duke
cameron_hall_(actor)	cameron_hall_(actor)
monica_sweetheart	monica_sweetheart
shauna_grant	shauna_grant
dolly_golden	dolly_golden
liu_wai-hung	liu_wai-hung
lam_ching-ying	lam_ching-ying
michiko_nomura	michiko_nomura
frank_conroy_(actor)	frank_conroy_(actor)
alex_fong_(singer)	alex_fong_(singer)
pierre_fitch	pierre_fitch
bernard_campan	bernard_campan
james_knight_(actor)	james_knight_(actor)
george_hulse	george_hulse
georgia_king	georgia_king
dan_young	dan_young
yasuo_tanaka_(voice_actor)	yasuo_tanaka_(voice_actor)
alexander_field_(actor)	alexander_field_(actor)
mark_chao	mark_chao
fred_groves_(actor)	fred_groves_(actor)
ma_tianyu	ma_tianyu
azumi_kawashima	azumi_kawashima
tom_judson	tom_judson
ann-mari_adamsson	ann-mari_adamsson
annie_cruz	annie_cruz
joan_chen	joan_chen
jakob_eklund	jakob_eklund
selina_jen	selina_jen
germaine_michel	germaine_michel
inday_ba	inday_ba
ashley_blue	ashley_blue
anthony_oliver	anthony_oliver
minnie_rayner	minnie_rayner
karen_dior	karen_dior
henry_hallett	henry_hallett
guy_newall	guy_newall
cedric_smith_(actor)	cedric_smith_(actor)
shawn_lee_(actor)	shawn_lee_(actor)
jeff_palmer	jeff_palmer
athole_stewart	athole_stewart
jenna_haze	jenna_haze
sue_longhurst	sue_longhurst
ken_lo	ken_lo
megan_zheng	megan_zheng
mirai_yamamoto	mirai_yamamoto
terry_scully	terry_scully
devinn_lane	devinn_lane
jessica_darlin	jessica_darlin
harold_warrender	harold_warrender
stina_ekblad	stina_ekblad
morton_selten	morton_selten
zhao_tao	zhao_tao
damien_crosse	damien_crosse
kim_peacock	kim_peacock
taija_rae	taija_rae
anne-marie_brunius	anne-marie_brunius
per_myrberg	per_myrberg
william_margold	william_margold
alexis_dubus	alexis_dubus
terry_walsh_(actor)	terry_walsh_(actor)
natalie_tong	natalie_tong
geoffrey_davies	geoffrey_davies
tina_russell	tina_russell
marcel_bozzuffi	marcel_bozzuffi
nina_li_(actress)	nina_li_(actress)
jacques_balutin	jacques_balutin
angel_dark	angel_dark
richard_leaf	richard_leaf
richard_cooper_(actor)	richard_cooper_(actor)
joey_stefano	joey_stefano
nicholas_phipps	nicholas_phipps
zhou_jie	zhou_jie
sacha_alexander	sacha_alexander
roman_tam	roman_tam
eve_balfour_(actress)	eve_balfour_(actress)
eve_matheson	eve_matheson
cora_miao	cora_miao
alan_tam	alan_tam
isao_kimura	isao_kimura
paul_valentine	paul_valentine
doris_svedlund	doris_svedlund
keni_styles	keni_styles
emi_wakui	emi_wakui
nana_yanagisawa	nana_yanagisawa
maurice_chevit	maurice_chevit
dudley_foster	dudley_foster
justine_joli	justine_joli
amanda_fahy	amanda_fahy
thom_barron	thom_barron
fuyumi_shiraishi	fuyumi_shiraishi
bridget_turner	bridget_turner
michelle_yeoh	michelle_yeoh
coralie_trinh_thi	coralie_trinh_thi
kay_parker	kay_parker
karen_lancaume	karen_lancaume
benjamin_yuen	benjamin_yuen
arthur_margetson	arthur_margetson
jenny_funnell	jenny_funnell
joseph_tremain	joseph_tremain
kiki_sheung	kiki_sheung
alina_plugaru	alina_plugaru
clara_morgane	clara_morgane
dayo_wong	dayo_wong
marina_kuroki	marina_kuroki
megan_leigh	megan_leigh
charlie_laine	charlie_laine
arthur_riscoe	arthur_riscoe
jimmy_lin	jimmy_lin
ernst_eklund_(actor)	ernst_eklund_(actor)
kunie_tanaka	kunie_tanaka
cat_simmons	cat_simmons
cindy_au	cindy_au
sinnamon_love	sinnamon_love
william_lindsay_(actor)	william_lindsay_(actor)
stephen_chow	stephen_chow
lisa_ann	lisa_ann
li_xiaoran	li_xiaoran
sybil_grove	sybil_grove
zhang_jizhong	zhang_jizhong
lau_kar-wing	lau_kar-wing
mimi_lo	mimi_lo
prudence_liew	prudence_liew
briana_blair	briana_blair
melissa_hill	melissa_hill
vincent_zhao	vincent_zhao
lee_heung-kam	lee_heung-kam
liana_bridges	liana_bridges
melanie_walters	melanie_walters
sydney_bromley	sydney_bromley
sonija_kwok	sonija_kwok
christopher_doyle	christopher_doyle
patrick_chesnais	patrick_chesnais
eitaro_ozawa	eitaro_ozawa
cassidey	cassidey
tiffany_tang	tiffany_tang
kim_anderzon	kim_anderzon
emil_forselius	emil_forselius
kitty_foxx	kitty_foxx
mickey_g.	mickey_g.
zhou_mi_(singer)	zhou_mi_(singer)
nenji_kobayashi	nenji_kobayashi
jackie_lane_(actress)	jackie_lane_(actress)
sonia_holm	sonia_holm
michel_beaune	michel_beaune
jesse_capelli	jesse_capelli
gia_paloma	gia_paloma
henry_bergman	henry_bergman
chor_yuen	chor_yuen
long_dong_silver	long_dong_silver
eddie_leslie	eddie_leslie
rena_tanaka	rena_tanaka
clifford_mollison	clifford_mollison
gretchen_(singer)	gretchen_(singer)
jacques_dumesnil	jacques_dumesnil
kelly_chen	kelly_chen
takako_tokiwa	takako_tokiwa
adam_thomas	adam_thomas
john_fawcett_(actor)	john_fawcett_(actor)
tania_mallet	tania_mallet
gao_yuanyuan	gao_yuanyuan
jean-louis_richard	jean-louis_richard
arletta_duncan	arletta_duncan
mickey_brantford	mickey_brantford
xie_shaoguang	xie_shaoguang
tor_isedal	tor_isedal
jacquie_lyn	jacquie_lyn
mieko_harada	mieko_harada
christer_flodin	christer_flodin
judith_baldwin	judith_baldwin
bernard_natan	bernard_natan
jennifer_daniel	jennifer_daniel
marcia_warren	marcia_warren
barbara_couper	barbara_couper
fernand_charpin	fernand_charpin
wallas_eaton	wallas_eaton
c.v._france	c.v._france
ulla_akselson	ulla_akselson
vanessa_demouy	vanessa_demouy
keiko_kishi	keiko_kishi
donald_eccles	donald_eccles
sunrise_adams	sunrise_adams
raymond_souplex	raymond_souplex
arthur_hardy_(actor)	arthur_hardy_(actor)
felicia_chin	felicia_chin
zhang_hanyu	zhang_hanyu
john_cheng	john_cheng
sybil_arundale	sybil_arundale
jullan_kindahl	jullan_kindahl
xu_jinglei	xu_jinglei
joanne_peh	joanne_peh
marcus_chin	marcus_chin
glennis_lorimer	glennis_lorimer
mikio_narita	mikio_narita
philippe_nicaud	philippe_nicaud
kika_markham	kika_markham
anneliese_van_der_pol	anneliese_van_der_pol
madison_young	madison_young
dicky_cheung	dicky_cheung
gunnar_olsson_(actor)	gunnar_olsson_(actor)
brittney_skye	brittney_skye
james_lindsay_(actor)	james_lindsay_(actor)
daniela_amavia	daniela_amavia
kit_chan	kit_chan
uschi_digard	uschi_digard
peter_madden_(actor)	peter_madden_(actor)
robert_party	robert_party
hou_yaowen	hou_yaowen
josephine_alhanko	josephine_alhanko
dale_meeks	dale_meeks
allan_wu	allan_wu
tzi_ma	tzi_ma
vera_day	vera_day
linda_lovelace	linda_lovelace
anne_crawford	anne_crawford
jennifer_metcalfe	jennifer_metcalfe
hiromi_nagasaku	hiromi_nagasaku
keri_windsor	keri_windsor
toshiyuki_toyonaga	toshiyuki_toyonaga
jack_wrangler	jack_wrangler
marcel_vibert	marcel_vibert
rayson_tan	rayson_tan
tamaki_katori	tamaki_katori
catalina_cruz	catalina_cruz
zena_marshall	zena_marshall
hugh_cross	hugh_cross
diana_beaumont	diana_beaumont
hikari_ishida	hikari_ishida
sylvia_chang	sylvia_chang
hiroyuki_miyasako	hiroyuki_miyasako
melissa_lauren	melissa_lauren
frida_hallgren	frida_hallgren
nina_hartley	nina_hartley
inga_gill	inga_gill
charles_lloyd-pack	charles_lloyd-pack
carl_forgione	carl_forgione
piers_flint-shipman	piers_flint-shipman
francesco_malcom	francesco_malcom
tyce_bune	tyce_bune
maho_toyota	maho_toyota
minoru_tanaka_(actor)	minoru_tanaka_(actor)
jeanne_de_casalis	jeanne_de_casalis
karl_gerhard	karl_gerhard
jean-pierre_kalfon	jean-pierre_kalfon
yang_mi	yang_mi
misa_watanabe	misa_watanabe
billy_chow	billy_chow
morgan_andersson	morgan_andersson
tag_adams	tag_adams
chieko_aioi	chieko_aioi
ix_shen	ix_shen
michelle_ye	michelle_ye
kate_more	kate_more
justin_deas	justin_deas
akira_emoto	akira_emoto
sakurako_kaoru	sakurako_kaoru
philippe_nahon	philippe_nahon
roland_hedlund	roland_hedlund
tsunehiko_watase	tsunehiko_watase
charlie_brill	charlie_brill
ella_koon	ella_koon
carrie_ng	carrie_ng
cathryn_harrison	cathryn_harrison
matt_chow	matt_chow
steve_shaw_(actor)	steve_shaw_(actor)
vivian_schmitt	vivian_schmitt
stina_berg	stina_berg
hanna_hilton	hanna_hilton
hinako_saeki	hinako_saeki
michiyo_okusu	michiyo_okusu
chems_dahmani	chems_dahmani
cindy_margolis	cindy_margolis
michaela_schaffrath	michaela_schaffrath
skye_bennett	skye_bennett
madeleine_milhaud	madeleine_milhaud
fumie_kashiyama	fumie_kashiyama
declan_mulholland	declan_mulholland
aaron_kwok	aaron_kwok
saori_hara	saori_hara
tiffany_mynx	tiffany_mynx
melissa_ng	melissa_ng
kimber_james	kimber_james
nicholas_tse	nicholas_tse
barbara_schulz	barbara_schulz
eric_stryker	eric_stryker
poppy_morgan	poppy_morgan
maho_nonami	maho_nonami
miki_yeung	miki_yeung
wilson_yip	wilson_yip
stig_olin	stig_olin
barrett_blade	barrett_blade
veronica_hart	veronica_hart
jade_seah	jade_seah
claude_bertrand_(actor)	claude_bertrand_(actor)
lena_bergman	lena_bergman
wang_baoqiang	wang_baoqiang
michelle_bauer	michelle_bauer
jean_worms	jean_worms
caroline_cellier	caroline_cellier
tatum_reed	tatum_reed
charles_cooper_(actor)	charles_cooper_(actor)
carlo_gabriel_nero	carlo_gabriel_nero
wendy_whoppers	wendy_whoppers
joyce_cheng	joyce_cheng
helga_thomas	helga_thomas
kristal_tin	kristal_tin
ravi_kapoor	ravi_kapoor
tomoko_maruo	tomoko_maruo
umewaka_minoru_i	umewaka_minoru_i
angelita_helena_maria_de_silva_ferro	angelita_helena_maria_de_silva_ferro
mikie_hara	mikie_hara
yu_rongguang	yu_rongguang
sissela_kyle	sissela_kyle
tsai_yi-chen	tsai_yi-chen
naomi_tani	naomi_tani
florence_kwok	florence_kwok
sarah_kazemy	sarah_kazemy
henri_attal	henri_attal
adrianna_lynn	adrianna_lynn
eiko_masuyama	eiko_masuyama
claude_gensac	claude_gensac
ronald_cheng	ronald_cheng
gabrielle_robinne	gabrielle_robinne
susan_shaw	susan_shaw
bernard_tiphaine	bernard_tiphaine
ryosuke_kagawa	ryosuke_kagawa
jason_hawke	jason_hawke
kang_cheng_xi	kang_cheng_xi
angelica_sin	angelica_sin
sandy_lam	sandy_lam
adolphe_lemoine	adolphe_lemoine
ben_warriss	ben_warriss
jay_simpson_(actor)	jay_simpson_(actor)
alfred_hickman	alfred_hickman
erica_campbell	erica_campbell
james_wong_(lyricist)	james_wong_(lyricist)
misty_rain	misty_rain
eve_angel	eve_angel
jun_fubuki	jun_fubuki
shigeru_nakahara	shigeru_nakahara
keve_hjelm	keve_hjelm
angela_morant	angela_morant
vivian_chow	vivian_chow
langhorn_burton	langhorn_burton
jean_heywood	jean_heywood
nozomi_momoi	nozomi_momoi
yammie_lam	yammie_lam
jam_hsiao	jam_hsiao
madoka_ozawa	madoka_ozawa
suzanne_dalbert	suzanne_dalbert
daniel_boulanger	daniel_boulanger
suki_chui	suki_chui
kumiko_aso	kumiko_aso
ian_hogg_(actor)	ian_hogg_(actor)
misty_dawn	misty_dawn
jean_desailly	jean_desailly
michel_etcheverry	michel_etcheverry
joe_melia	joe_melia
fridolf_rhudin	fridolf_rhudin
stirling_gallacher	stirling_gallacher
bao_guo'an	bao_guo'an
john_hopkins_(actor)	john_hopkins_(actor)
stella_farentino	stella_farentino
charles_lamy	charles_lamy
adeline_hayden_coffin	adeline_hayden_coffin
amelia_bayntun	amelia_bayntun
deborah_makepeace	deborah_makepeace
lilian_braithwaite	lilian_braithwaite
richenda_carey	richenda_carey
wan_yeung-ming	wan_yeung-ming
reon_kadena	reon_kadena
hacken_lee	hacken_lee
cynthia_koh	cynthia_koh
roland_giraud	roland_giraud
dong_jie	dong_jie
roy_herrick	roy_herrick
loretta_yang	loretta_yang
jim_o'connolly	jim_o'connolly
emmanuelle_boidron	emmanuelle_boidron
mayumi_yamaguchi	mayumi_yamaguchi
daphne_heard	daphne_heard
juliet_anderson	juliet_anderson
eiko_koike	eiko_koike
hung_sin-nui	hung_sin-nui
jennifer_rhodes	jennifer_rhodes
valda_setterfield	valda_setterfield
peter_bull	peter_bull
aria_giovanni	aria_giovanni
sophia_rossi	sophia_rossi
ruthie_henshall	ruthie_henshall
wolf_hudson	wolf_hudson
lawrence_chou	lawrence_chou
nicola_cheung	nicola_cheung
michael_lucas_(director)	michael_lucas_(director)
eva_fontaine	eva_fontaine
eiji_okuda	eiji_okuda
shy_love	shy_love
zhang_yimou	zhang_yimou
jamie_gillis	jamie_gillis
samantha_strong	samantha_strong
mona_geijer-falkner	mona_geijer-falkner
dana_dearmond	dana_dearmond
andrew_seow	andrew_seow
andy_lau	andy_lau
genie_chuo	genie_chuo
ellen_parker_(actress)	ellen_parker_(actress)
theresa_fu	theresa_fu
masahiro_inoue	masahiro_inoue
sarah_vandella	sarah_vandella
jewel_de'nyle	jewel_de'nyle
nick_cheung	nick_cheung
anna-lisa_baude	anna-lisa_baude
richard_mayes	richard_mayes
karena_lam	karena_lam
john_garrick	john_garrick
ava_vincent	ava_vincent
jennifer_luv	jennifer_luv
barbara_yung	barbara_yung
max_mok	max_mok
benny_yau	benny_yau
serena_gordon	serena_gordon
brewster_mason	brewster_mason
jerrold_robertshaw	jerrold_robertshaw
john_hewer	john_hewer
malin_ek	malin_ek
cherrie_ying	cherrie_ying
mitsuki_tanimura	mitsuki_tanimura
mimi_nelson	mimi_nelson
sandrine_kiberlain	sandrine_kiberlain
alexandra_lamy	alexandra_lamy
marcelle_chantal	marcelle_chantal
david_buck	david_buck
walter_hudd	walter_hudd
chris_tranchell	chris_tranchell
vidkid_timo	vidkid_timo
jiang_wu	jiang_wu
gaynor_rowlands	gaynor_rowlands
ted_thin_elk	ted_thin_elk
bruce_le	bruce_le
claude_france	claude_france
kathy_chow	kathy_chow
ken_mitsuda	ken_mitsuda
koji_yamamoto_(actor)	koji_yamamoto_(actor)
gerald_ames	gerald_ames
tutta_rolf	tutta_rolf
rex_chandler	rex_chandler
john_bernard_(actor)	john_bernard_(actor)
cyril_luckham	cyril_luckham
kayoko_kishimoto	kayoko_kishimoto
eric_barclay	eric_barclay
erik_everhard	erik_everhard
madison_stone	madison_stone
howard_gaye	howard_gaye
g.e.m._(singer)	g.e.m._(singer)
walter_tennyson	walter_tennyson
jon_dough	jon_dough
bree_olson	bree_olson
guo_tao_(actor)	guo_tao_(actor)
patrick_alexandroni	patrick_alexandroni
runa_akiyama	runa_akiyama
john_baskcomb	john_baskcomb
felix_wong	felix_wong
adrian_hall_(actor)	adrian_hall_(actor)
sydnee_steele	sydnee_steele
sune_mangs	sune_mangs
colin_chase	colin_chase
birgitta_valberg	birgitta_valberg
arisa_komiya	arisa_komiya
chapman_to	chapman_to
rolf_skoglund	rolf_skoglund
stephen_wong_ka-lok	stephen_wong_ka-lok
jeffrey_perry_(british_actor)	jeffrey_perry_(british_actor)
lexi_belle	lexi_belle
kaitlyn_ashley	kaitlyn_ashley
coco_lee	coco_lee
johnnie_schofield	johnnie_schofield
malcolm_cherry	malcolm_cherry
berta_hall	berta_hall
flower_tucci	flower_tucci
shinsuke_ashida	shinsuke_ashida
moses_chan	moses_chan
moya_brady	moya_brady
jo_rowbottom	jo_rowbottom
bobby_au-yeung	bobby_au-yeung
kaylynn	kaylynn
jean_kemm	jean_kemm
mayumi_ogawa	mayumi_ogawa
jenna_presley	jenna_presley
hilary_pritchard	hilary_pritchard
chen_hong_(actress)	chen_hong_(actress)
nicolas_duvauchelle	nicolas_duvauchelle
asa_akira	asa_akira
marjorie_fielding	marjorie_fielding
sophie_barjac	sophie_barjac
pu_cunxin	pu_cunxin
dawson_millward	dawson_millward
eiji_kanie	eiji_kanie
barbara_gott	barbara_gott
leslie_graves	leslie_graves
rosamund_kwan	rosamund_kwan
stephen_clancy_hill	stephen_clancy_hill
mayumi_asano	mayumi_asano
ulla_jacobsson	ulla_jacobsson
satomi_kobayashi	satomi_kobayashi
linda_hardy	linda_hardy
jean_marchat	jean_marchat
wallace_huo	wallace_huo
gloria_leonard	gloria_leonard
nancy_wu	nancy_wu
brian_miller_(actor)	brian_miller_(actor)
lena_nitro	lena_nitro
paule_andral	paule_andral
vivian_hsu	vivian_hsu
wendy_williams_(pornographic_actress)	wendy_williams_(pornographic_actress)
henry_saari	henry_saari
zhu_xu	zhu_xu
bunny_bleu	bunny_bleu
chew_chor_meng	chew_chor_meng
bengt_djurberg	bengt_djurberg
paula_shaw	paula_shaw
alfred_lundberg	alfred_lundberg
michelle_thorne	michelle_thorne
kaori_shimizu_(voice_actress)	kaori_shimizu_(voice_actress)
faith_brook	faith_brook
mya_diamond	mya_diamond
nadia_styles	nadia_styles
abel_tarride	abel_tarride
lacie_heart	lacie_heart
yuki_ninagawa	yuki_ninagawa
jean-pierre_castaldi	jean-pierre_castaldi
fewlass_llewellyn	fewlass_llewellyn
jeremy_brock	jeremy_brock
anna_malle	anna_malle
britt_morgan	britt_morgan
shinichi_tsutsumi	shinichi_tsutsumi
yumi_shirakawa	yumi_shirakawa
christian_marin	christian_marin
nicholas_teo	nicholas_teo
jimmy_aubrey	jimmy_aubrey
stuart_wade	stuart_wade
hugh_sinclair_(actor)	hugh_sinclair_(actor)
pierre_maguelon	pierre_maguelon
don_fernando	don_fernando
philip_ng	philip_ng
joe_cheng	joe_cheng
bobby_troup	bobby_troup
paw_hee-ching	paw_hee-ching
belinda_hamnett	belinda_hamnett
tania_russof	tania_russof
hidetaka_yoshioka	hidetaka_yoshioka
ulf_larsson	ulf_larsson
mc_jin	mc_jin
arty_ash	arty_ash
han_geng	han_geng
lela_star	lela_star
margit_manstad	margit_manstad
cate_harrington	cate_harrington
ku_feng	ku_feng
lucien_guitry	lucien_guitry
anita_yuen	anita_yuen
allan_bohlin	allan_bohlin
lo_wei	lo_wei
zeng_huifen	zeng_huifen
edmond_leung	edmond_leung
farid_chopel	farid_chopel
lydia_shum	lydia_shum
lacy_rose	lacy_rose
flex-deon_blake	flex-deon_blake
zak_spears	zak_spears
amguulan	amguulan
justin_slayer	justin_slayer
mika_tan	mika_tan
claude_melki	claude_melki
mirai_shida	mirai_shida
serge_sauvion	serge_sauvion
leila_birch	leila_birch
britta_brunius	britta_brunius
bradford_thomas_wagner	bradford_thomas_wagner
mie_kitahara	mie_kitahara
yvonne_de_bray	yvonne_de_bray
rita_cadillac_(brazilian_entertainer)	rita_cadillac_(brazilian_entertainer)
julia_ann	julia_ann
masanari_nihei	masanari_nihei
arthur_bostrom	arthur_bostrom
kanako_fukaura	kanako_fukaura
alice_connor	alice_connor
jenny_platt	jenny_platt
nakamura_nakazo_i	nakamura_nakazo_i
johan_rabaeus	johan_rabaeus
nicolas_bataille	nicolas_bataille
jean_yonnel	jean_yonnel
yuen_wah	yuen_wah
erica_fontes	erica_fontes
shino_kakinuma	shino_kakinuma
sidney_vivian	sidney_vivian
sia_berkeley	sia_berkeley
miki_mizuno	miki_mizuno
jet_li	jet_li
horace_hodges	horace_hodges
ovidie	ovidie
meggie_albanesi	meggie_albanesi
birgit_tengroth	birgit_tengroth
sun_daolin	sun_daolin
peter_tilbury	peter_tilbury
mike_he	mike_he
cj_gibson	cj_gibson
wang_luoyong	wang_luoyong
kaho_minami	kaho_minami
maria_cordero	maria_cordero
judy_buxton	judy_buxton
jessica_sweet	jessica_sweet
ekin_cheng	ekin_cheng
denmei_suzuki	denmei_suzuki
yang_libing	yang_libing
fann_wong	fann_wong
george_fant	george_fant
michael_stefano	michael_stefano
anthony_crane	anthony_crane
john_glyn-jones	john_glyn-jones
tyra_misoux	tyra_misoux
alexis_fire	alexis_fire
julia_foster	julia_foster
abella_anderson	abella_anderson
vanness_wu	vanness_wu
megumi_sato_(actress)	megumi_sato_(actress)
gabrielle_brune	gabrielle_brune
avy_scott	avy_scott
george_kuwa	george_kuwa
tatsuya_fuji	tatsuya_fuji
deep_ng	deep_ng
aleska_diamond	aleska_diamond
jonathan_linsley	jonathan_linsley
rachel_ashley	rachel_ashley
ai_iijima	ai_iijima
alan_gifford	alan_gifford
eiji_okada	eiji_okada
kikko_matsuoka	kikko_matsuoka
nick_manning	nick_manning
rufus_(actor)	rufus_(actor)
jamie_borthwick	jamie_borthwick
sasha_grey	sasha_grey
colette_marchand	colette_marchand
alex_reid_(actress)	alex_reid_(actress)
vickery_turner	vickery_turner
guillaume_gouix	guillaume_gouix
eiko_ando	eiko_ando
anthony_hulme	anthony_hulme
lung_fong	lung_fong
tamao_nakamura	tamao_nakamura
milk_ichigo	milk_ichigo
eileen_moore	eileen_moore
john_marlborough_east	john_marlborough_east
richard_bird_(actor)	richard_bird_(actor)
henri_nassiet	henri_nassiet
katherine_locke	katherine_locke
gail_sheridan	gail_sheridan
jeanette_aw	jeanette_aw
saki_seto	saki_seto
maria_kawamura	maria_kawamura
nobuko_miyamoto	nobuko_miyamoto
janey_robbins	janey_robbins
katalin_vad	katalin_vad
amy_ried	amy_ried
li_bingbing	li_bingbing
frederick_culley	frederick_culley
louis_salou	louis_salou
elaine_yiu	elaine_yiu
suzana_alves	suzana_alves
ray_lui	ray_lui
duncan_mcrae_(actor)	duncan_mcrae_(actor)
choi_kwok-wai	choi_kwok-wai
chen_hao_(actress)	chen_hao_(actress)
claudia_claire	claudia_claire
gong_qiuxia	gong_qiuxia
lee_siu-kei	lee_siu-kei
angelina_valentine	angelina_valentine
hilda_spong	hilda_spong
alice_henley	alice_henley
dany_verissimo	dany_verissimo
marguerite_moreno	marguerite_moreno
helen_shingler	helen_shingler
megumi_urawa	megumi_urawa
jeffrey_lau	jeffrey_lau
henri_virlogeux	henri_virlogeux
taiki_matsuno	taiki_matsuno
anna_cropper	anna_cropper
shirley_kwan	shirley_kwan
michelle_reis	michelle_reis
hitomi_kuroki	hitomi_kuroki
kate_baines	kate_baines
jonas_karlsson	jonas_karlsson
katie_rolfsen	katie_rolfsen
bobby_hollander	bobby_hollander
sven_lindberg	sven_lindberg
laura_smet	laura_smet
suzy_prim	suzy_prim
jane_booker	jane_booker
minoru_yada	minoru_yada
jana_jordan	jana_jordan
stephen_fung	stephen_fung
karin_schubert	karin_schubert
teddy_robin	teddy_robin
bai_guang	bai_guang
miho_maeshima	miho_maeshima
tomoko_tabata	tomoko_tabata
dyanna_lauren	dyanna_lauren
chen_hanwei	chen_hanwei
jeannie_pepper	jeannie_pepper
arthur_walcott	arthur_walcott
henri_cogan	henri_cogan
barrie_gosney	barrie_gosney
megumi_kagurazaka	megumi_kagurazaka
reiko_takashima	reiko_takashima
naemi_briese	naemi_briese
helen_haye	helen_haye
a.e._coleby	a.e._coleby
john_ekman	john_ekman
taka_kato	taka_kato
teresa_orlowski	teresa_orlowski
kumiko_akiyoshi	kumiko_akiyoshi
marjorie_rhodes	marjorie_rhodes
michael_sharvell-martin	michael_sharvell-martin
kanon_kasuga	kanon_kasuga
stormy_daniels	stormy_daniels
teagan_presley	teagan_presley
bojan_westin	bojan_westin
holly_sampson	holly_sampson
david_king-wood	david_king-wood
chen_sicheng	chen_sicheng
estelle_skornik	estelle_skornik
ian_whyte_(actor)	ian_whyte_(actor)
rikard_wolff	rikard_wolff
jason_crew	jason_crew
chyna	chyna
christy_canyon	christy_canyon
melvil_poupaud	melvil_poupaud
angela_summers	angela_summers
mitsuaki_hoshino	mitsuaki_hoshino
jana_cova	jana_cova
ernest_sefton	ernest_sefton
michael_brandon_(pornographic_actor)	michael_brandon_(pornographic_actor)
yumiko_fujita	yumiko_fujita
inari_vachs	inari_vachs
vince_vouyer	vince_vouyer
ingvar_kjellson	ingvar_kjellson
stacy_valentine	stacy_valentine
halina_tam	halina_tam
chizuru_ikewaki	chizuru_ikewaki
helena_pickard	helena_pickard
lesley_wareing	lesley_wareing
akira_kubo	akira_kubo
akio_nojima	akio_nojima
maria_antonietta_beluzzi	maria_antonietta_beluzzi
william_hung	william_hung
lisa_s.	lisa_s.
youki_kudoh	youki_kudoh
estelle_desanges	estelle_desanges
kristal_summers	kristal_summers
taketoshi_naito	taketoshi_naito
jacques_gamblin	jacques_gamblin
ming_dao	ming_dao
xie_na	xie_na
evan_stone	evan_stone
patricia_maynard	patricia_maynard
wendy_divine	wendy_divine
john_welsh_(actor)	john_welsh_(actor)
kenix_kwok	kenix_kwok
sire_ma	sire_ma
sita_chan	sita_chan
zheng_junli	zheng_junli
mami_higashiyama	mami_higashiyama
lilian_bond	lilian_bond
chung_king-fai	chung_king-fai
shingo_tsurumi	shingo_tsurumi
moana_pozzi	moana_pozzi
kaoru_shimamura	kaoru_shimamura
roy_cheung	roy_cheung
yuan_muzhi	yuan_muzhi
pat_myne	pat_myne
bert_wynne	bert_wynne
valentine_tessier	valentine_tessier
david_dencik	david_dencik
morio_kazama	morio_kazama
jay_grdina	jay_grdina
candy_samples	candy_samples
david_niven,_jr.	david_niven,_jr.
mathilde_seigner	mathilde_seigner
nike_arrighi	nike_arrighi
maria_yamamoto	maria_yamamoto
steve_railsback	steve_railsback
paulina_james	paulina_james
xu_qing	xu_qing
cara_lott	cara_lott
arne_ragneborn	arne_ragneborn
beatrice_hsu	beatrice_hsu
carmen_luvana	carmen_luvana
ariel_lin	ariel_lin
david_crellin	david_crellin
wei_wei_(actress)	wei_wei_(actress)
ann_kok	ann_kok
lau_kong	lau_kong
kobe_tai	kobe_tai
huang_shengyi	huang_shengyi
briana_banks	briana_banks
eric_bransby_williams	eric_bransby_williams
charles_holland_(actor)	charles_holland_(actor)
lena_halliday	lena_halliday
akiji_kobayashi	akiji_kobayashi
hebe_tien	hebe_tien
armand_kaliz	armand_kaliz
marianne_denicourt	marianne_denicourt
tien_feng	tien_feng
wong_cho-lam	wong_cho-lam
karl_erik_flens	karl_erik_flens
brandy_alexandre	brandy_alexandre
huang_xiaoming	huang_xiaoming
rakuto_tochihara	rakuto_tochihara
micheline_dax	micheline_dax
monica_mayhem	monica_mayhem
kaku_takashina	kaku_takashina
denise_grey	denise_grey
sally_yoshino	sally_yoshino
adam_chen	adam_chen
julia_lockwood	julia_lockwood
brooke_skye	brooke_skye
alfred_paget	alfred_paget
mckenzie_lee	mckenzie_lee
james_stephenson	james_stephenson
michelle_chong	michelle_chong
deborah_norton	deborah_norton
shermon_tang	shermon_tang
philip_merivale	philip_merivale
anders_ek	anders_ek
barbro_kollberg	barbro_kollberg
colleen_brennan	colleen_brennan
bosco_wong	bosco_wong
maxime_leroux	maxime_leroux
martin_ljung	martin_ljung
erica_ellyson	erica_ellyson
christian_vadim	christian_vadim
georgann_johnson	georgann_johnson
tom_reynolds_(actor)	tom_reynolds_(actor)
li_xiaolu	li_xiaolu
george_innes	george_innes
erica_boyer	erica_boyer
gudrun_brost	gudrun_brost
joey_meng	joey_meng
fala_chen	fala_chen
michelle_ferre	michelle_ferre
raoul_billerey	raoul_billerey
hitomi_shiraishi	hitomi_shiraishi
holly_kaneko	holly_kaneko
fritha_goodey	fritha_goodey
alexis_amore	alexis_amore
john_light_(actor)	john_light_(actor)
conleth_hill	conleth_hill
alex_fong_(actor)	alex_fong_(actor)
lin_meijiao	lin_meijiao
charles_heslop	charles_heslop
tsui_siu-ming	tsui_siu-ming
charles_carson_(actor)	charles_carson_(actor)
ranko_hanai	ranko_hanai
jean_chapot	jean_chapot
michiko_maeda	michiko_maeda
a.e._george	a.e._george
jan_erik_lindqvist	jan_erik_lindqvist
yngve_gamlin	yngve_gamlin
muriel_frances_dana	muriel_frances_dana
joshua_ang	joshua_ang
lacy_ryan	lacy_ryan
danni_ashe	danni_ashe
toni_edgar-bruce	toni_edgar-bruce
jennifer_ketcham	jennifer_ketcham
hilda_moore	hilda_moore
ai_maeda_(voice_actress)	ai_maeda_(voice_actress)
jack_hobbs_(actor)	jack_hobbs_(actor)
pamela_green	pamela_green
david_gale_(actor)	david_gale_(actor)
jenny_tschernichin-larsson	jenny_tschernichin-larsson
van_damage	van_damage
deric_wan	deric_wan
meggan_mallone	meggan_mallone
ashli_orion	ashli_orion
teru_shimada	teru_shimada
jenny_tseng	jenny_tseng
katja_kassin	katja_kassin
zeb_atlas	zeb_atlas
carmen_hart	carmen_hart
julian_cheung	julian_cheung
ian_kelsey	ian_kelsey
roy_stewart	roy_stewart
maya_gold	maya_gold
noriko_sengoku	noriko_sengoku
viviane_ventura	viviane_ventura
fraser_ayres	fraser_ayres
patrick_guillemin	patrick_guillemin
anand_rajaram	anand_rajaram
miyuki_ueda	miyuki_ueda
julia_taylor	julia_taylor
sachiko_murase	sachiko_murase
collin_chou	collin_chou
emily_woof	emily_woof
roger_karl	roger_karl
katja_k	katja_k
henry_longhurst_(actor)	henry_longhurst_(actor)
hay_plumb	hay_plumb
holly_one	holly_one
masami_suzuki	masami_suzuki
nigel_barrie	nigel_barrie
berg_ng	berg_ng
bertha_belmore	bertha_belmore
xu_fan	xu_fan
jack_trevor	jack_trevor
sarah_song	sarah_song
toshiyuki_hosokawa	toshiyuki_hosokawa
dane_cross	dane_cross
shannon_lee	shannon_lee
joe_ma_(actor)	joe_ma_(actor)
candy_apples	candy_apples
henri_castelli	henri_castelli
josie_ho	josie_ho
masahiro_usui	masahiro_usui
kuranosuke_sasaki	kuranosuke_sasaki
sola_aoi	sola_aoi
tyrell_davis	tyrell_davis
bernice_liu	bernice_liu
sandrine_pinna	sandrine_pinna
lex_shrapnel	lex_shrapnel
julie_night	julie_night
yuki_sato_(actor)	yuki_sato_(actor)
rakel_liekki	rakel_liekki
patrick_tse	patrick_tse
mami_yamasaki	mami_yamasaki
lisa_sparks	lisa_sparks
seymore_butts	seymore_butts
wakin_chau	wakin_chau
shiho_fujimura	shiho_fujimura
joyzelle_joyner	joyzelle_joyner
muga_takewaki	muga_takewaki
ryo_kimura	ryo_kimura
ryoko_yonekura	ryoko_yonekura
ingrid_luterkort	ingrid_luterkort
mia_murano	mia_murano
tiana_lynn	tiana_lynn
lou_charmelle	lou_charmelle
yoko_shimada	yoko_shimada
marianne_aminoff	marianne_aminoff
tomiko_ishii	tomiko_ishii
takeshi_kaneshiro	takeshi_kaneshiro
yasuko_sawaguchi	yasuko_sawaguchi
harry_korris	harry_korris
matthew_marsh_(actor)	matthew_marsh_(actor)
diana_pang	diana_pang
jelena_jensen	jelena_jensen
jaime_chik	jaime_chik
tavalia_griffin	tavalia_griffin
sinn_sage	sinn_sage
annabel_chong	annabel_chong
brandi_love	brandi_love
yumika_hayashi	yumika_hayashi
henric_holmberg	henric_holmberg
jean_marsan	jean_marsan
amber_rayne	amber_rayne
jack_wu	jack_wu
kin_sugai	kin_sugai
song_dandan	song_dandan
kristy_yang	kristy_yang
birger_malmsten	birger_malmsten
douglas_seale	douglas_seale
guy_disilva	guy_disilva
rikiya_otaka	rikiya_otaka
judd_green	judd_green
lu_yi_(actor)	lu_yi_(actor)
barbro_flodquist	barbro_flodquist
mary_forbes	mary_forbes
bengt_ekerot	bengt_ekerot
jonathan_newth	jonathan_newth
francesco_d'macho	francesco_d'macho
seiichi_tanabe	seiichi_tanabe
eric_kot	eric_kot
roy_byford	roy_byford
joy_garrett	joy_garrett
charlene_tse	charlene_tse
casey_donovan_(actor)	casey_donovan_(actor)
keri_sable	keri_sable
charles_berling	charles_berling
lisa_lu	lisa_lu
yvonne_lombard	yvonne_lombard
yorke_sherwood	yorke_sherwood
tin_kai-man	tin_kai-man
sture_lagerwall	sture_lagerwall
kaoru_yachigusa	kaoru_yachigusa
ma_sanli	ma_sanli
rod_fontana	rod_fontana
elizabeth_berrington	elizabeth_berrington
yoshinori_okada	yoshinori_okada
paulette_noizeux	paulette_noizeux
lezley_zen	lezley_zen
kelly_lin	kelly_lin
bruno_pradal	bruno_pradal
kanji_tsuda	kanji_tsuda
james_tien_(actor)	james_tien_(actor)
drusilla_wills	drusilla_wills
mark_kingston	mark_kingston
sue_hodge	sue_hodge
robert_le_vigan	robert_le_vigan
nanako_matsushima	nanako_matsushima
ken_yamauchi	ken_yamauchi
joe_shaw_(actor)	joe_shaw_(actor)
janet_dibley	janet_dibley
claudine_beccarie	claudine_beccarie
william_snape	william_snape
richie_jen	richie_jen
armand_dutertre	armand_dutertre
roberto_malone	roberto_malone
deidre_holland	deidre_holland
polly_ward	polly_ward
johnni_black	johnni_black
francis_perrin_(actor)	francis_perrin_(actor)
bryan_leung	bryan_leung
jia_nailiang	jia_nailiang
yuriko_yamaguchi_(voice_actress)	yuriko_yamaguchi_(voice_actress)
arthur_rigby_(actor)	arthur_rigby_(actor)
brigitta_bulgari	brigitta_bulgari
sakura_sena	sakura_sena
daniel_chan	daniel_chan
leslie_bradley	leslie_bradley
ai_kobayashi	ai_kobayashi
masato_furuoya	masato_furuoya
jean_martinelli	jean_martinelli
nobuo_nakamura	nobuo_nakamura
margaret_lacey	margaret_lacey
rene_bond	rene_bond
ellen_chan	ellen_chan
caroline_carver_(actor)	caroline_carver_(actor)
geraldine_o'rawe	geraldine_o'rawe
marc_wallice	marc_wallice
alan_tang	alan_tang
yuriko_yamamoto	yuriko_yamamoto
dan_ekborg	dan_ekborg
wu_yingyin	wu_yingyin
paul_sorensen	paul_sorensen
barbie_hsu	barbie_hsu
brigitte_lahaie	brigitte_lahaie
teddy_arundell	teddy_arundell
herbert_lomas_(actor)	herbert_lomas_(actor)
yoshino_kimura	yoshino_kimura
ilona_staller	ilona_staller
hiroyuki_nagato	hiroyuki_nagato
honoka	honoka
natalis_chan	natalis_chan
roberta_gemma	roberta_gemma
yvette_bova	yvette_bova
barbara_dare	barbara_dare
gigi_leung	gigi_leung
andreas_wilson	andreas_wilson
david_ross_(actor)	david_ross_(actor)
lymari_nadal	lymari_nadal
nora_miao	nora_miao
raymond_hermantier	raymond_hermantier
camilla_power	camilla_power
reika_hashimoto	reika_hashimoto
minoru_chiaki	minoru_chiaki
shakira_caine	shakira_caine
tomohiro_kaku	tomohiro_kaku
lillian_zuckerman	lillian_zuckerman
joan_kemp-welch	joan_kemp-welch
max_maxudian	max_maxudian
marguerite_pierry	marguerite_pierry
zhang_yuqi	zhang_yuqi
natalia_zeta	natalia_zeta
maria_kekkonen	maria_kekkonen
aden_gillett	aden_gillett
vincent_lindon	vincent_lindon
ann_bridgewater	ann_bridgewater
athena_chu	athena_chu
clive_graham	clive_graham
paige_chua	paige_chua
mandy_bright	mandy_bright
charlton_heston	charlton_heston
yuko_kobayashi	yuko_kobayashi
keiron_self	keiron_self
pierre_png	pierre_png
lin_feng-jiao	lin_feng-jiao
catherine_sutherland	catherine_sutherland
chen_xiuhuan	chen_xiuhuan
jean_claudio	jean_claudio
rebecca_bardoux	rebecca_bardoux
gigi_lai	gigi_lai
gerd_hagman	gerd_hagman
clement_mccallin	clement_mccallin
jarl_kulle	jarl_kulle
norm_grabowski	norm_grabowski
minori_aoi	minori_aoi
katy_murphy	katy_murphy
ulf_brunnberg	ulf_brunnberg
richard_lund	richard_lund
marie_luv	marie_luv
ryan_idol	ryan_idol
amanda_ooms	amanda_ooms
angus_mackay_(actor)	angus_mackay_(actor)
ashlynn_brooke	ashlynn_brooke
marilyn_jess	marilyn_jess
penelope_dudley-ward	penelope_dudley-ward
david_gwillim	david_gwillim
pascal_mazzotti	pascal_mazzotti
rosie_day	rosie_day
jun_kusanagi	jun_kusanagi
betty_lawford	betty_lawford
tara_lynn_foxx	tara_lynn_foxx
ellen_chaplin	ellen_chaplin
zheng_geping	zheng_geping
monica_mattos	monica_mattos
jiang_qinqin	jiang_qinqin
michiyo_kogure	michiyo_kogure
jeanne_mockford	jeanne_mockford
jake_deckard	jake_deckard
niki_chow	niki_chow
pierre_boulanger	pierre_boulanger
lau_kar-leung	lau_kar-leung
wakana_yamazaki	wakana_yamazaki
kate_asabuki	kate_asabuki
toni_ribas	toni_ribas
eri_kikuchi	eri_kikuchi
mark_daly_(actor)	mark_daly_(actor)
maurice_garrel	maurice_garrel
paul_frankeur	paul_frankeur
ariel_rebel	ariel_rebel
katie_morgan	katie_morgan
sammo_hung	sammo_hung
shawn_yue	shawn_yue
wilfred_lau	wilfred_lau
wade_nichols	wade_nichols
annette_schwarz	annette_schwarz
nikita_ramsey	nikita_ramsey
hugh_burden	hugh_burden
brooke_haven	brooke_haven
mary_millington	mary_millington
alex_jordan	alex_jordan
olivia_saint	olivia_saint
raylene	raylene
ah_niu	ah_niu
jack_ellis_(actor)	jack_ellis_(actor)
fubuki_takane	fubuki_takane
candy_lo	candy_lo
thomas_jouannet	thomas_jouannet
renji_ishibashi	renji_ishibashi
keith_drinkel	keith_drinkel
takeo_chii	takeo_chii
folke_sundquist	folke_sundquist
chiara_mastroianni	chiara_mastroianni
linsey_dawn_mckenzie	linsey_dawn_mckenzie
brittany_andrews	brittany_andrews
alektra_blue	alektra_blue
julie_k._smith	julie_k._smith
roxy_jezel	roxy_jezel
li_qian_(actress)	li_qian_(actress)
julian_royce	julian_royce
tolga_safer	tolga_safer
nobuko_otowa	nobuko_otowa
chloe_howman	chloe_howman
angela_tong	angela_tong
jenna_jameson	jenna_jameson
candida_royalle	candida_royalle
eva_angelina	eva_angelina
walter_fitzgerald	walter_fitzgerald
asami_kai	asami_kai
john_botvid	john_botvid
rin_aoki	rin_aoki
soh_hang-suen	soh_hang-suen
dale_dabone	dale_dabone
shin_saburi	shin_saburi
aaron_yan	aaron_yan
fritiof_billquist	fritiof_billquist
desmond_jeans	desmond_jeans
tollie_zellman	tollie_zellman
catrin_westerlund	catrin_westerlund
ady_an	ady_an
tom_chatto	tom_chatto
bengt_eklund	bengt_eklund
mai_lin	mai_lin
arpad_miklos	arpad_miklos
darren_james	darren_james
parineeti_chopra	parineeti_chopra
julia_channel	julia_channel
ryan_thomas	ryan_thomas
kenneth_ma	kenneth_ma
salma_de_nora	salma_de_nora
kristi_myst	kristi_myst
deborah_findlay	deborah_findlay
julia_dietze	julia_dietze
louise_hampton	louise_hampton
thomas_henty	thomas_henty
jackie_chan	jackie_chan
tomoyuki_dan	tomoyuki_dan
you_yong	you_yong
robin_irvine	robin_irvine
martin_lev	martin_lev
kitana_baker	kitana_baker
stig_lasseby	stig_lasseby
zhang_ziyi	zhang_ziyi
frankie_chan	frankie_chan
john_shrapnel	john_shrapnel
calli_cox	calli_cox
katie_gold	katie_gold
patricia_mok	patricia_mok
richard_pacheco	richard_pacheco
vincent_davies	vincent_davies
flora_chan	flora_chan
sara_bernat	sara_bernat
bellan_roos	bellan_roos
derek_lord	derek_lord
yvonne_yung	yvonne_yung
fred_goodwins	fred_goodwins
ivy_lee_(actress)	ivy_lee_(actress)
naomi_chance	naomi_chance
ryosei_konishi	ryosei_konishi
zhao_lirong	zhao_lirong
priscelia_chan	priscelia_chan
alf_kjellin	alf_kjellin
you_(actress)	you_(actress)
michael_tse	michael_tse
tina_leung	tina_leung
jason_hsu	jason_hsu
li_xuejian	li_xuejian
matt_king_(comedian)	matt_king_(comedian)
masami_kikuchi	masami_kikuchi
maria-elena_laas	maria-elena_laas
raquel_cassidy	raquel_cassidy
greg_centauro	greg_centauro
freddie_boath	freddie_boath
ken_mitsuishi	ken_mitsuishi
graeme_hawley	graeme_hawley
mary_meade	mary_meade
ken_yamaguchi	ken_yamaguchi
charles_dullin	charles_dullin
dany_robin	dany_robin
susan_skipper	susan_skipper
tori_black	tori_black
michael_knowles_(actor)	michael_knowles_(actor)
jessica_hsuan	jessica_hsuan
seiran_kobayashi	seiran_kobayashi
cathy_barry	cathy_barry
roxanne_blaze	roxanne_blaze
belita	belita
bobby_vitale	bobby_vitale
yoshio_inaba	yoshio_inaba
muriel_aked	muriel_aked
dave_cummings	dave_cummings
kazumi_tanaka	kazumi_tanaka
vic_polizos	vic_polizos
wilber_pan	wilber_pan
kaho_(actress)	kaho_(actress)
ron_hightower	ron_hightower
kazue_itoh	kazue_itoh
sammi_cheng	sammi_cheng
alex_etel	alex_etel
yasmine_lafitte	yasmine_lafitte
nicky_wu	nicky_wu
junie_astor	junie_astor
leah_luv	leah_luv
gary_hailes	gary_hailes
sayoko_yamaguchi	sayoko_yamaguchi
victoria_paris	victoria_paris
li_nanxing	li_nanxing
roy_travers	roy_travers
tom_kempinski	tom_kempinski
richard_dolman	richard_dolman
kristina_adolphson	kristina_adolphson
mary_rorke	mary_rorke
sumiko_hidaka	sumiko_hidaka
mimi_miyagi	mimi_miyagi
rosalind_ayres	rosalind_ayres
brigitte_lin	brigitte_lin
george_relph	george_relph
asuka_sakamaki	asuka_sakamaki
jean_del_val	jean_del_val
tericka_dye	tericka_dye
gene_gerrard	gene_gerrard
amber_lynn	amber_lynn
yasuko_matsuyuki	yasuko_matsuyuki
bokuzen_hidari	bokuzen_hidari
manami_yoshii	manami_yoshii
chen_shucheng	chen_shucheng
teruyuki_kagawa	teruyuki_kagawa
wiktor_andersson	wiktor_andersson
miho_nikaido	miho_nikaido
christian_barbier	christian_barbier
zhang_jingchu	zhang_jingchu
richard_ng	richard_ng
bernard_lancret	bernard_lancret
sunset_thomas	sunset_thomas
chie_sawaguchi	chie_sawaguchi
tony_leung_ka-fai	tony_leung_ka-fai
eric_wan	eric_wan
jessie_st._james	jessie_st._james
miki_sawaguchi	miki_sawaguchi
fred_emney	fred_emney
julian_hee	julian_hee
tawny_roberts	tawny_roberts
julie_meadows	julie_meadows
hyapatia_lee	hyapatia_lee
hideko_yoshida	hideko_yoshida
michael_lonsdale	michael_lonsdale
belle_chrystall	belle_chrystall
ivy_ling_po	ivy_ling_po
louise_frevert	louise_frevert
patrick_tam_(actor)	patrick_tam_(actor)
shane_diesel	shane_diesel
jack_lambert_(british_actor)	jack_lambert_(british_actor)
yuriko_hanabusa	yuriko_hanabusa
flora_finch	flora_finch
sam_bernard	sam_bernard
hubert_saint-macary	hubert_saint-macary
thomas_heathcote	thomas_heathcote
dana_vespoli	dana_vespoli
nikki_tyler	nikki_tyler
lisa_boyle	lisa_boyle
masato_hagiwara	masato_hagiwara
svea_holst	svea_holst
debi_sue_voorhees	debi_sue_voorhees
pat_keen	pat_keen
amelia_shankley	amelia_shankley
akira_watase	akira_watase
hannah_harper	hannah_harper
bowie_wu	bowie_wu
yuma_asami	yuma_asami
queenie_chu	queenie_chu
yoyo_mung	yoyo_mung
eloy_azorin	eloy_azorin
bryan_wong	bryan_wong
jeff_stryker	jeff_stryker
monica_chan	monica_chan
jiang_wen	jiang_wen
yvonne_lim	yvonne_lim
liza_wang	liza_wang
eileen_percy	eileen_percy
leila_tong	leila_tong
josephine_siao	josephine_siao
evelyn_tan	evelyn_tan
bridgette_kerkove	bridgette_kerkove
hollie_stevens	hollie_stevens
chris_larkin	chris_larkin
josette_simon	josette_simon
philippe_volter	philippe_volter
luo_jin	luo_jin
ane_dahl_torp	ane_dahl_torp
jacky_heung	jacky_heung
chloe_jones	chloe_jones
sture_ericson	sture_ericson
elliot_ngok	elliot_ngok
isao_yamagata	isao_yamagata
ernest_butcher	ernest_butcher
michel_nastorg	michel_nastorg
mako_(voice_actress)	mako_(voice_actress)
gertan_klauber	gertan_klauber
gwei_lun-mei	gwei_lun-mei
beverly_lynne	beverly_lynne
michael_martin_harvey	michael_martin_harvey
taylor_rain	taylor_rain
stanley_huang	stanley_huang
takumi_yamazaki	takumi_yamazaki
fuyukichi_maki	fuyukichi_maki
kristina_wayborn	kristina_wayborn
kenny_bee	kenny_bee
anita_rinaldi	anita_rinaldi
lai_lok-yi	lai_lok-yi
hayato_ichihara	hayato_ichihara
julian_firth	julian_firth
felicia_tang	felicia_tang
ikue_sakakibara	ikue_sakakibara
domonique_simone	domonique_simone
stig_johanson	stig_johanson
wang_gang_(actor)	wang_gang_(actor)
masaki_okada	masaki_okada
dagmar_olsson	dagmar_olsson
ron_jeremy	ron_jeremy
kimiko_matsuzaka	kimiko_matsuzaka
juli_ashton	juli_ashton
kenneth_kent	kenneth_kent
shayla_laveaux	shayla_laveaux
bobbi_starr	bobbi_starr
tiffany_million	tiffany_million
chi_chi_larue	chi_chi_larue
felicia_fox	felicia_fox
ang_ching_hui	ang_ching_hui
franklin_dyall	franklin_dyall
annalisa_ericson	annalisa_ericson
john_hollis	john_hollis
rachel_ryan	rachel_ryan
sasha_gabor	sasha_gabor
katsuni	katsuni
antonio_resines	antonio_resines
fiona_xie	fiona_xie
lisa_de_leeuw	lisa_de_leeuw
marie_wright	marie_wright
ginger_lynn	ginger_lynn
ran_ito	ran_ito
akiko_wakabayashi	akiko_wakabayashi
hiroshi_tsuburaya	hiroshi_tsuburaya
rocco_siffredi	rocco_siffredi
anna_lindahl	anna_lindahl
isabel_ice	isabel_ice
mary_dibley	mary_dibley
aylar_lie	aylar_lie
scott_o'hara	scott_o'hara
hideo_murota	hideo_murota
anthony_rosano	anthony_rosano
dallas_anderson_(actress)	dallas_anderson_(actress)
jason_chan_(singer)	jason_chan_(singer)
taeko_kawata	taeko_kawata
noel_leung	noel_leung
madeleine_renaud	madeleine_renaud
nils_poppe	nils_poppe
dolly_buster	dolly_buster
aurore_auteuil	aurore_auteuil
bionca	bionca
luc_andrieux	luc_andrieux
angelique_morgan	angelique_morgan
alan_tern	alan_tern
junko_miyashita	junko_miyashita
cecilia_gessa	cecilia_gessa
remy_lacroix	remy_lacroix
bret_wolfe	bret_wolfe
ayako_wakao	ayako_wakao
crystal_knight	crystal_knight
nici_sterling	nici_sterling
ray_dragon	ray_dragon
kazue_ikura	kazue_ikura
miyoko_asada	miyoko_asada
herbert_bunston	herbert_bunston
ittoku_kishibe	ittoku_kishibe
danny_green_(actor)	danny_green_(actor)
jennifer_stewart	jennifer_stewart
edward_lexy	edward_lexy
sharon_luk	sharon_luk
joan_maude	joan_maude
michiyo_aratama	michiyo_aratama
keiran_lee	keiran_lee
aileen_raymond	aileen_raymond
joey_silvera	joey_silvera
timmy_hung	timmy_hung
show_luo	show_luo
hubert_deschamps	hubert_deschamps
marco_banderas	marco_banderas
herschel_savage	herschel_savage
ha_yu_(actor)	ha_yu_(actor)
zhang_guoli	zhang_guoli
so_yamamura	so_yamamura
suzy_mandel	suzy_mandel
kent_tong	kent_tong
jean-pierre_darras	jean-pierre_darras
tristan_kingsley	tristan_kingsley
bailey_jay	bailey_jay
erik_strandmark	erik_strandmark
chen_daoming	chen_daoming
brenda_vaccaro	brenda_vaccaro
matt_gunther	matt_gunther
giani_esposito	giani_esposito
huang_bo	huang_bo
cyril_mclaglen	cyril_mclaglen
philippa_gail	philippa_gail
tomio_aoki	tomio_aoki
peter_swanwick	peter_swanwick
signe_wirff	signe_wirff
mai_haruna	mai_haruna
derek_deadman	derek_deadman
jing_tian	jing_tian
riko_tachibana	riko_tachibana
ellen_pollock	ellen_pollock
gillian_chung	gillian_chung
erik_rhodes_(pornographic_actor)	erik_rhodes_(pornographic_actor)
rebecca_brooke	rebecca_brooke
alistair_petrie	alistair_petrie
julie_strain	julie_strain
tsui_hark	tsui_hark
louis_fan	louis_fan
adam_cheng	adam_cheng
evan_seinfeld	evan_seinfeld
christian_xxx	christian_xxx
alexandra_silk	alexandra_silk
ichiro_sugai	ichiro_sugai
pierre_etchepare	pierre_etchepare
joe_cheung	joe_cheung
julie-marie_parmentier	julie-marie_parmentier
joe_chen	joe_chen
angelica_lee	angelica_lee
michel_galabru	michel_galabru
juliana_donald	juliana_donald
sydney_fairbrother	sydney_fairbrother
nils_hallberg	nils_hallberg
wang_lung-wei	wang_lung-wei
ken_ryker	ken_ryker
maggie_shiu	maggie_shiu
sophie_dee	sophie_dee
lysa_thatcher	lysa_thatcher
elof_ahrle	elof_ahrle
alec_su	alec_su
vincent_kok	vincent_kok
majandra_delfino	majandra_delfino
jasmine_byrne	jasmine_byrne
susanna_kwan	susanna_kwan
veronica_carlson	veronica_carlson
racquel_darrian	racquel_darrian
concordia_selander	concordia_selander
lila_leslie	lila_leslie
mike_morgan_(actor)	mike_morgan_(actor)
cecil_humphreys	cecil_humphreys
susan_stephen	susan_stephen
osamu_takizawa	osamu_takizawa
toshiko_fujita	toshiko_fujita
pauline_chan_bo-lin	pauline_chan_bo-lin
stephen_billington	stephen_billington
philip_middlemiss	philip_middlemiss
chris_jury	chris_jury
sunny_chan	sunny_chan
davina_craig	davina_craig
power_chan	power_chan
david_lloyd_meredith	david_lloyd_meredith
denise_coffey	denise_coffey
tsutomu_yamazaki	tsutomu_yamazaki
sven-eric_gamble	sven-eric_gamble
dagny_lind	dagny_lind
kate_hardie	kate_hardie
aileen_tan	aileen_tan
cara_fawn	cara_fawn
william_austin_(actor)	william_austin_(actor)
rebecca_saire	rebecca_saire
eleanor_summerfield	eleanor_summerfield
william_marlowe	william_marlowe
gallen_lo	gallen_lo
naoki_sugiura	naoki_sugiura
simon_de_la_brosse	simon_de_la_brosse
sami_frey	sami_frey
masaaki_tsukada	masaaki_tsukada
porsche_lynn	porsche_lynn
greta_almroth	greta_almroth
bertil_malmberg	bertil_malmberg
jeannie_carson	jeannie_carson
liu_ye_(actor)	liu_ye_(actor)
jenny_alpha	jenny_alpha
clifford_rose	clifford_rose
grace_chang	grace_chang
charles_rock	charles_rock
lexi_love	lexi_love
strelsa_brown	strelsa_brown
yu_nan	yu_nan
michel_constantin	michel_constantin
toivo_pawlo	toivo_pawlo
ayaka_wilson	ayaka_wilson
isabelle_nanty	isabelle_nanty
yngve_nordwall	yngve_nordwall
michael-joel_david_stuart	michael-joel_david_stuart
alien_sun	alien_sun
amber_kuo	amber_kuo
ingrid_backlin	ingrid_backlin
yoshiko_tanaka	yoshiko_tanaka
tanya_tate	tanya_tate
pai_ping-ping	pai_ping-ping
nao_saejima	nao_saejima
paul_chung	paul_chung
robert_urquhart_(actor)	robert_urquhart_(actor)
simeon_stuart	simeon_stuart
yuen_cheung-yan	yuen_cheung-yan
janet_jacme	janet_jacme
michel_drach	michel_drach
frances_white	frances_white
blake_riley	blake_riley
reina_leone	reina_leone
patricia_brake	patricia_brake
sayuri_yamauchi	sayuri_yamauchi
jack_neo	jack_neo
bunny_luv	bunny_luv
michael_graham_cox	michael_graham_cox
jenny_tomasin	jenny_tomasin
an_nanba	an_nanba
roxy_reynolds	roxy_reynolds
sharka_blue	sharka_blue
viola_compton	viola_compton
kate_tsui	kate_tsui
rosemarie_ford	rosemarie_ford
mandy_chiang	mandy_chiang
chris_perry-metcalf	chris_perry-metcalf
kim_hartman	kim_hartman
sam_chan	sam_chan
jeremy_spenser	jeremy_spenser
alfred_denville	alfred_denville
olof_sandborg	olof_sandborg
irene_lindh	irene_lindh
blue_washington	blue_washington
taylor_vixen	taylor_vixen
kjeld_gogosha-clark	kjeld_gogosha-clark
keiko_toda	keiko_toda
betty_ann_davies	betty_ann_davies
pierre_palau	pierre_palau
calvin_chen	calvin_chen
angie_cheong	angie_cheong
ryo_kase	ryo_kase
cordelia_bugeja	cordelia_bugeja
pihla_viitala	pihla_viitala
mary_kerridge	mary_kerridge
mario_montez	mario_montez
mary_jean_reimer	mary_jean_reimer
kelly_nichols	kelly_nichols
madeleine_robinson	madeleine_robinson
lena_t._hansson	lena_t._hansson
song_wenfei	song_wenfei
india_summer	india_summer
chow_yun-fat	chow_yun-fat
marc_de_jonge	marc_de_jonge
haruki_mizuno	haruki_mizuno
kwan_hoi-san	kwan_hoi-san
ambrosine_phillpotts	ambrosine_phillpotts
reine_brynolfsson	reine_brynolfsson
tom_riley_(actor)	tom_riley_(actor)
scott_nails	scott_nails
andy_san_dimas	andy_san_dimas
keiko_takahashi	keiko_takahashi
jean_davy	jean_davy
lina_ng	lina_ng
d._j._williams_(actor)	d._j._williams_(actor)
bak_sheut-sin	bak_sheut-sin
gillian_blake	gillian_blake
yoshiya_minami	yoshiya_minami
jun_murakami	jun_murakami
gaston_jacquet	gaston_jacquet
jean_mamy	jean_mamy
david_hutcheson	david_hutcheson
jean_boht	jean_boht
roger_blin	roger_blin
claire_duhamel	claire_duhamel
john_grillo	john_grillo
thierry_fortineau	thierry_fortineau
christine_ng	christine_ng
daniel_chatto	daniel_chatto
linda_chung	linda_chung
christi_lake	christi_lake
ann_trevor	ann_trevor
aimee_sweet	aimee_sweet
violet_graham	violet_graham
hu_die	hu_die
breanne_benson	breanne_benson
stuart_burge	stuart_burge
eileen_essell	eileen_essell
kelly_trump	kelly_trump
yoko_moriguchi	yoko_moriguchi
idy_chan	idy_chan
william_larsson	william_larsson
keith_pyott	keith_pyott
shaun_chen	shaun_chen
nicki_hunter	nicki_hunter
jacklyn_wu	jacklyn_wu
esther_sandoval	esther_sandoval
yoichi_numata	yoichi_numata
rolf_sohlman	rolf_sohlman
buck_adams	buck_adams
kristara_barrington	kristara_barrington
gina_hiraizumi	gina_hiraizumi
yukie_kawamura	yukie_kawamura
pippa_haywood	pippa_haywood
kwan_tak-hing	kwan_tak-hing
carl-axel_heiknert	carl-axel_heiknert
mako_midori	mako_midori
brooke_ballentyne	brooke_ballentyne
adia_chan	adia_chan
alana_evans	alana_evans
aletta_ocean	aletta_ocean
hiroko_mita	hiroko_mita
kaylani_lei	kaylani_lei
victor_stanley	victor_stanley
lyrian	lyrian
tomoyo_harada	tomoyo_harada
may_lo	may_lo
bo_brundin	bo_brundin
guo_degang	guo_degang
chihiro_hasegawa	chihiro_hasegawa
hugh_mitchell_(actor)	hugh_mitchell_(actor)
georg_funkquist	georg_funkquist
alex_to	alex_to
misa_uehara_(actress,_born_1983)	misa_uehara_(actress,_born_1983)
vivian_wu	vivian_wu
jimmy_nah	jimmy_nah
jade_leung	jade_leung
birger_lensander	birger_lensander
kim_chambers	kim_chambers
denise_ho	denise_ho
maurice_baquet	maurice_baquet
naho_toda	naho_toda
seka	seka
alicia_rhodes	alicia_rhodes
minami_aoyama	minami_aoyama
wu_ma	wu_ma
william_san	william_san
toby_leung	toby_leung
roy_chiao	roy_chiao
m.a._wetherell	m.a._wetherell
jean_dara	jean_dara
ayumi_ishida_(actress)	ayumi_ishida_(actress)
brianna_love	brianna_love
lulu_popplewell	lulu_popplewell
kelly_madison	kelly_madison
iemasa_kayumi	iemasa_kayumi
kevin_cheng	kevin_cheng
erik_hell	erik_hell
camilla_sparv	camilla_sparv
marcus_london	marcus_london
masaya_kato	masaya_kato
li_wenhai_(actor)	li_wenhai_(actor)
anna_palk	anna_palk
mark_ryder	mark_ryder
noel_coleman	noel_coleman
tristan_mathews	tristan_mathews
harvey_spencer_stephens	harvey_spencer_stephens
philip_stainton	philip_stainton
erica_carlson	erica_carlson
riria_yoshikawa	riria_yoshikawa
rodney_diak	rodney_diak
emily_fitzroy	emily_fitzroy
bai_hong	bai_hong
isabelle_corey	isabelle_corey
tetsushi_tanaka	tetsushi_tanaka
graham_pountney	graham_pountney
mark_cheng	mark_cheng
hiroshi_mikami	hiroshi_mikami
chingmy_yau	chingmy_yau
alysson_paradis	alysson_paradis
liu_yifei	liu_yifei
jia_hongsheng	jia_hongsheng
ron_ng	ron_ng
joyce_bland	joyce_bland
maggie_lau	maggie_lau
caroline_milmoe	caroline_milmoe
yasuhisa_furuhara	yasuhisa_furuhara
fred_rains	fred_rains
robert_moor	robert_moor
jean-baptiste_nicolet	jean-baptiste_nicolet
jane_welsh	jane_welsh
cheung_siu-fai	cheung_siu-fai
kaoru_kobayashi_(actor)	kaoru_kobayashi_(actor)
claude_maki	claude_maki
scott_sunderland_(actor)	scott_sunderland_(actor)
richard_dillane	richard_dillane
janet_henfrey	janet_henfrey
keiko_aizawa	keiko_aizawa
aubrey_mather	aubrey_mather
kei_mizutani	kei_mizutani
nozomi_takeuchi	nozomi_takeuchi
fay_helm	fay_helm
ben_dover	ben_dover
xavier_saint-macary	xavier_saint-macary
wilde_oscar	wilde_oscar
dennis_king	dennis_king
gordon_mcleod_(actor)	gordon_mcleod_(actor)
agda_helin	agda_helin
john_moulder-brown	john_moulder-brown
angela_chang	angela_chang
laure_sainclair	laure_sainclair
taylor_wane	taylor_wane
zeffie_tilbury	zeffie_tilbury
terence_cao	terence_cao
yumi_asou	yumi_asou
myolie_wu	myolie_wu
bunjaku_han	bunjaku_han
kazuo_hasegawa	kazuo_hasegawa
edward_shuter	edward_shuter
eriko_hara	eriko_hara
damian_lau	damian_lau
brenda_de_banzie	brenda_de_banzie
janine_lindemulder	janine_lindemulder
kwong_wa	kwong_wa
john_stagliano	john_stagliano
vincent_wong	vincent_wong
mona_seilitz	mona_seilitz
joanna_taylor	joanna_taylor
raven_riley	raven_riley
leslie_cheung	leslie_cheung
john_melin	john_melin
colette_darfeuil	colette_darfeuil
dennis_law_(film_director)	dennis_law_(film_director)
ian_collier	ian_collier
elliott_mason	elliott_mason
herbert_evans_(actor)	herbert_evans_(actor)
tera_wray	tera_wray
stan_shaw	stan_shaw
terence_yin	terence_yin
ricky_hui	ricky_hui
eva_henger	eva_henger
randy_spears	randy_spears
enid_stamp_taylor	enid_stamp_taylor
roger_legris	roger_legris
zhou_xun	zhou_xun
rosanne_wong	rosanne_wong
vahina_giocante	vahina_giocante
yuria_haga	yuria_haga
kerri_hoskins	kerri_hoskins
alice_de_winton	alice_de_winton
tora_teje	tora_teje
john_richardson_(actor)	john_richardson_(actor)
hans_ernback	hans_ernback
fiona_sit	fiona_sit
larry_taylor_(actor)	larry_taylor_(actor)
seiji_miyaguchi	seiji_miyaguchi
barry_wong	barry_wong
john_j._carney	john_j._carney
carmel_moore	carmel_moore
tyson_cane	tyson_cane
lara_roxx	lara_roxx
joan_rice	joan_rice
bobbi_eden	bobbi_eden
cristina_bella	cristina_bella
stacia_napierkowska	stacia_napierkowska
aino_taube	aino_taube
carman_lee	carman_lee
chad_knight	chad_knight
arthur_leslie	arthur_leslie
siqin_gaowa	siqin_gaowa
haley_paige	haley_paige
dominique_darel	dominique_darel
brian_nissen	brian_nissen
chiharu_kawai	chiharu_kawai
vincent_winter	vincent_winter
huang_yi_(actress)	huang_yi_(actress)
magnus_kesster	magnus_kesster
amber_agar	amber_agar
kokoro_amano	kokoro_amano
monique_demoan	monique_demoan
edward_atterton	edward_atterton
alex_fletcher_(actress)	alex_fletcher_(actress)
shunji_fujimura	shunji_fujimura
annu_mari	annu_mari
kermit_love	kermit_love
kenneth_tsang	kenneth_tsang
angela_mao	angela_mao
mr._marcus	mr._marcus
huang_yiliang	huang_yiliang
megumi_okina	megumi_okina
tony_tedeschi	tony_tedeschi
harriette_deborah_lacy	harriette_deborah_lacy
sun_ma_sze_tsang	sun_ma_sze_tsang
melissa_harrington	melissa_harrington
asako_fujii	asako_fujii
guy_bedos	guy_bedos
eleanor_matsuura	eleanor_matsuura
priscila_sol_(pornographic_actress)	priscila_sol_(pornographic_actress)
sibelle_hu	sibelle_hu
james_lloyd_(actor)	james_lloyd_(actor)
hisashi_igawa	hisashi_igawa
joseph_a._bennett	joseph_a._bennett
pierre_doris	pierre_doris
marcel_maupi	marcel_maupi
georgina_spelvin	georgina_spelvin
richard_caldicot	richard_caldicot
rikiya_yasuoka	rikiya_yasuoka
su_elliot	su_elliot
meguru_kosaka	meguru_kosaka
masanobu_takashima	masanobu_takashima
riley_reid	riley_reid
yumi_takada	yumi_takada
nicole_sheridan	nicole_sheridan
courtney_simpson	courtney_simpson
shigenori_yamazaki	shigenori_yamazaki
toshiya_ueda	toshiya_ueda
romeo_tan	romeo_tan
faith_brown	faith_brown
christopher_godwin	christopher_godwin
louis_cheung	louis_cheung
hans_klinga	hans_klinga
fumio_watanabe	fumio_watanabe
marvin_goldhar	marvin_goldhar
joanna_angel	joanna_angel
joey_yung	joey_yung
takaaki_ishibashi	takaaki_ishibashi
eason_chan	eason_chan
charlene_choi	charlene_choi
sandra_romain	sandra_romain
louis_koo	louis_koo
ron_bottitta	ron_bottitta
tavia_yeung	tavia_yeung
huang_biren	huang_biren
sunny_leone	sunny_leone
chihiro_otsuka	chihiro_otsuka
martin_walker_(actor)	martin_walker_(actor)
mana_sakura	mana_sakura
john_deverell	john_deverell
tamara_lees	tamara_lees
lolo_ferrari	lolo_ferrari
sharla_cheung	sharla_cheung
saburo_date	saburo_date
rei_igarashi	rei_igarashi
miriam_yeung	miriam_yeung
jordan_chan	jordan_chan
robert_vattier	robert_vattier
christa_theret	christa_theret
kylie_ireland	kylie_ireland
karl-arne_holmsten	karl-arne_holmsten
frankie_lam	frankie_lam
will_adamsdale	will_adamsdale
ngo_ka-nin	ngo_ka-nin
marc_pickering	marc_pickering
charmaine_sheh	charmaine_sheh
arthur_young_(actor)	arthur_young_(actor)
angela_clarke	angela_clarke
roger_vincent	roger_vincent
james_grout	james_grout
steven_st._croix	steven_st._croix
guy_marchand	guy_marchand
satine_phoenix	satine_phoenix
masato_harada	masato_harada
courtney_cummz	courtney_cummz
lasse_krantz	lasse_krantz
emi_kuroda	emi_kuroda
george_lam	george_lam
gustaf_molander	gustaf_molander
ivy_close	ivy_close
charles_le_bargy	charles_le_bargy
dennis_arundell	dennis_arundell
maurice_maillot	maurice_maillot
anita_west	anita_west
cowley_wright	cowley_wright
mina_anwar	mina_anwar
gull_natorp	gull_natorp
annette_benson	annette_benson
roland_curram	roland_curram
gracie_glam	gracie_glam
tang_pik-wan	tang_pik-wan
liu_xiao_ling_tong	liu_xiao_ling_tong
tina_yuzuki	tina_yuzuki
kazuko_shirakawa	kazuko_shirakawa
mark_singleton_(actor)	mark_singleton_(actor)
kenny_doughty	kenny_doughty
wilfred_shine	wilfred_shine
tanya_lopert	tanya_lopert
reiko_oshida	reiko_oshida
victor_travers	victor_travers
krysti_lynn	krysti_lynn
wallace_lupino	wallace_lupino
maruse_taro	maruse_taro
hu_jun	hu_jun
ann_marie_rios	ann_marie_rios
joey_leung	joey_leung
janet_lees_price	janet_lees_price
shuji_kashiwabara	shuji_kashiwabara
mitsuko_mito	mitsuko_mito
wong_tin-lam	wong_tin-lam
vicky_vette	vicky_vette
lauritz_falk	lauritz_falk
hugh_pryse	hugh_pryse
frederick_burtwell	frederick_burtwell
hajime_hana	hajime_hana
charles_goldner	charles_goldner
takuzo_kawatani	takuzo_kawatani
marilyn_chambers	marilyn_chambers
cavan_kendall	cavan_kendall
wang_yumei	wang_yumei
sachiko_hidari	sachiko_hidari
jay_ashley	jay_ashley
takanori_hoshino	takanori_hoshino
trina_michaels	trina_michaels
lisa_lipps	lisa_lipps
stanley_caine	stanley_caine
hideki_ogihara	hideki_ogihara
alex_mackenzie	alex_mackenzie
komaki_kurihara	komaki_kurihara
jessica_drake	jessica_drake
hitomi_kobayashi	hitomi_kobayashi
jessica_jaymes	jessica_jaymes
naomi_radcliffe	naomi_radcliffe
chan_shen	chan_shen
claude_faraldo	claude_faraldo
ian_paul_cassidy	ian_paul_cassidy
lally_bowers	lally_bowers
carl-axel_elfving	carl-axel_elfving
claude_nollier	claude_nollier
bengt_logardt	bengt_logardt
natasha_o'keeffe	natasha_o'keeffe
irma_christenson	irma_christenson
vic_chou	vic_chou
yuria_kato	yuria_kato
rex_o'malley	rex_o'malley
nana_natsume	nana_natsume
bowie_lam	bowie_lam
anita_wall	anita_wall
stefani_morgan	stefani_morgan
yui_ichikawa	yui_ichikawa
ryo_hitomi	ryo_hitomi
barbara_new	barbara_new
john_bentley_(actor)	john_bentley_(actor)
chen_xiaoxu	chen_xiaoxu
rebecca_chan	rebecca_chan
anthony_wong_(hong_kong_actor)	anthony_wong_(hong_kong_actor)
margaretha_krook	margaretha_krook
sei_ashina	sei_ashina
tae_kimura	tae_kimura
enzo_squillino,_jr.	enzo_squillino,_jr.
nicholas_mcgaughey	nicholas_mcgaughey
zhou_xuan	zhou_xuan
akiho_yoshizawa	akiho_yoshizawa
machiko_toyoshima	machiko_toyoshima
gaby_stenberg	gaby_stenberg
jimmy_godden	jimmy_godden
michael_gaunt	michael_gaunt
anastasia_mayo	anastasia_mayo
kimberly_kane	kimberly_kane
kanichi_kurita	kanichi_kurita
kenji_wu	kenji_wu
felecia	felecia
mark_womack_(british_actor)	mark_womack_(british_actor)
ruby_lin	ruby_lin
bibi_jones	bibi_jones
francesca_le	francesca_le
rick_pantera	rick_pantera
miyuki_ono	miyuki_ono
avis_bunnage	avis_bunnage
brent_everett	brent_everett
birgitta_pettersson	birgitta_pettersson
koreya_senda	koreya_senda
antonia_brough	antonia_brough
sacha_briquet	sacha_briquet
francis_lister	francis_lister
marthe_mercadier	marthe_mercadier
loni_sanders	loni_sanders
jean_daurand	jean_daurand
vanessa_blue	vanessa_blue
helge_hagerman	helge_hagerman
edvin_adolphson	edvin_adolphson
jamie_brooks_(actress)	jamie_brooks_(actress)
chen_liping	chen_liping
lauren_phoenix	lauren_phoenix
christina_schollin	christina_schollin
lea_de_mae	lea_de_mae
ava_rose	ava_rose
steven_ma	steven_ma
jeremy_wilkin	jeremy_wilkin
qi_yuwu	qi_yuwu
julian_bleach	julian_bleach
etsushi_toyokawa	etsushi_toyokawa
gilbert_lam	gilbert_lam
mutsuko_sakura	mutsuko_sakura
henry_mollison	henry_mollison
abel_jacquin	abel_jacquin
yuriko_ishida	yuriko_ishida
rosemary_leach	rosemary_leach
sosuke_ikematsu	sosuke_ikematsu
mirai_moriyama	mirai_moriyama
paul_crauchet	paul_crauchet
celia_gregory	celia_gregory
reiko_kataoka	reiko_kataoka
akiko_matsumoto	akiko_matsumoto
chang_chen-yue	chang_chen-yue
chrissie_white	chrissie_white
kiwako_taichi	kiwako_taichi
tanner_mayes	tanner_mayes
judy_minx	judy_minx
dyanne_thorne	dyanne_thorne
stacey_cadman	stacey_cadman
wanda_curtis	wanda_curtis
ben_field	ben_field
chieko_honda	chieko_honda
jesse_jane	jesse_jane
jenaveve_jolie	jenaveve_jolie
rosanna_carter	rosanna_carter
jacqueline_sassard	jacqueline_sassard
simone_griffeth	simone_griffeth
felix_lok	felix_lok
shu_qi	shu_qi
bridget_powers	bridget_powers
sif_ruud	sif_ruud
teresa_mo	teresa_mo
jessica_brooks	jessica_brooks
rachel_de_solla	rachel_de_solla
vivien_yeo	vivien_yeo
ayumi_ito	ayumi_ito
lilli_carati	lilli_carati
matthew_beard_(british_actor)	matthew_beard_(british_actor)
sally_yeh	sally_yeh
douglas_munro_(actor)	douglas_munro_(actor)
ona_zee	ona_zee
john_turnbull_(actor)	john_turnbull_(actor)
stoya	stoya
colin_edwynn	colin_edwynn
asia_carrera	asia_carrera
victoria_zdrok	victoria_zdrok
masaya_takatsuka	masaya_takatsuka
jane_marken	jane_marken
wong_he	wong_he
miho_shiraishi	miho_shiraishi
robin_byrd	robin_byrd
taylor_st._claire	taylor_st._claire
isa_quensel	isa_quensel
john_paul_(actor)	john_paul_(actor)
zhu_houren	zhu_houren
olof_widgren	olof_widgren
shirley_yeung	shirley_yeung
chikage_awashima	chikage_awashima
hiroyuki_ikeuchi	hiroyuki_ikeuchi
kenji_matsuda	kenji_matsuda
puma_swede	puma_swede
benjamin_beresford	benjamin_beresford
harry_ahlin	harry_ahlin
selen	selen
george_barraud	george_barraud
bernard_le_coq	bernard_le_coq
benny_chan_(actor)	benny_chan_(actor)
roger_dutoit	roger_dutoit
david_gooderson	david_gooderson
narumi_yasuda	narumi_yasuda
hy_hazell	hy_hazell
dominique_davray	dominique_davray
manuel_ferrara	manuel_ferrara
jeanette_sterke	jeanette_sterke
bertil_anderberg	bertil_anderberg
mai_hoshikawa	mai_hoshikawa
lynn_lemay	lynn_lemay
corinne_alphen	corinne_alphen
blake_harper	blake_harper
juno_mak	juno_mak
justin_lo	justin_lo
julian_chagrin	julian_chagrin
yuen_biao	yuen_biao
audrey_hollander	audrey_hollander
caroline_harker	caroline_harker
jeanna_fine	jeanna_fine
kayden_kross	kayden_kross
julien_rassam	julien_rassam
arata_iura	arata_iura
derek_farr	derek_farr
sam_lee_(actor)	sam_lee_(actor)
nina_mercedez	nina_mercedez
adriana_sage	adriana_sage
arthur_malet	arthur_malet
michelle_goh	michelle_goh
angela_pan	angela_pan
jordan_metcalfe	jordan_metcalfe
jackie_sardou	jackie_sardou
kiichi_nakai	kiichi_nakai
firmine_richard	firmine_richard
maurice_risch	maurice_risch
takanori_jinnai	takanori_jinnai
jukichi_uno	jukichi_uno
colton_ford	colton_ford
jacky_cheung	jacky_cheung
richard_ainley	richard_ainley
ola_rapace	ola_rapace
ikki_sawamura	ikki_sawamura
aya_sugimoto	aya_sugimoto
hsiao_ho_(actor)	hsiao_ho_(actor)
india_fisher	india_fisher
jacques_duby	jacques_duby
cameron_marshall	cameron_marshall
jerry_yan	jerry_yan
oscar_ljung	oscar_ljung
wellington_a._playter	wellington_a._playter
ian_gouw	ian_gouw
ashley_long	ashley_long
yoshiko_kuga	yoshiko_kuga
bonnie_holiday	bonnie_holiday
gunnar_nielsen_(actor)	gunnar_nielsen_(actor)
kurumi_morishita	kurumi_morishita
edison_chen	edison_chen
gina_lynn	gina_lynn
nene_otsuka	nene_otsuka
chen_yunshang	chen_yunshang
peggy_novak	peggy_novak
raymond_lam	raymond_lam
yoshifumi_tajima	yoshifumi_tajima
donnie_yen	donnie_yen
ethan_juan	ethan_juan
chi_kuan-chun	chi_kuan-chun
ken_chu	ken_chu
taiten_kusunoki	taiten_kusunoki
zhao_wei	zhao_wei
jesse_santana	jesse_santana
darren_lim	darren_lim
samir_guesmi	samir_guesmi
karina_nose	karina_nose
maria_takagi	maria_takagi
alec_fraser	alec_fraser
tore_svennberg	tore_svennberg
georg_rydeberg	georg_rydeberg
russell_wong	russell_wong
gabriel_alw	gabriel_alw
john_hanson_(singer)	john_hanson_(singer)
claude_titre	claude_titre
isabelle_amyes	isabelle_amyes
bob_haymes	bob_haymes
xiang_yun	xiang_yun
sydney_paxton	sydney_paxton
barry_k._barnes	barry_k._barnes
maya_okamoto	maya_okamoto
lois_ayres	lois_ayres
zhang_fengyi	zhang_fengyi
chan_hung-lit	chan_hung-lit
per-axel_arosenius	per-axel_arosenius
shyla_foxxx	shyla_foxxx
albert_dupontel	albert_dupontel
hedli_anderson	hedli_anderson
arihiro_fujimura	arihiro_fujimura
rainie_yang	rainie_yang
teresa_carpio	teresa_carpio
kazusa_murai	kazusa_murai
gordon_lam	gordon_lam
hong_huifang	hong_huifang
judy_gunn	judy_gunn
adam_campbell_(actor)	adam_campbell_(actor)
kristina_rose	kristina_rose
dorris_bowdon	dorris_bowdon
alexandra_quinn	alexandra_quinn
ken_uehara	ken_uehara
kei_suma	kei_suma
bernard_blier	bernard_blier
jean-claude_michel	jean-claude_michel
li_shing-cheong	li_shing-cheong
lou_gish	lou_gish
mayura_hoshitsuki	mayura_hoshitsuki
stacey_tendeter	stacey_tendeter
natasha_kiss	natasha_kiss
jun_hamamura	jun_hamamura
winnie_lau	winnie_lau
george_a._cooper	george_a._cooper
valen_hsu	valen_hsu
stanley_lebor	stanley_lebor
marlene_willoughby	marlene_willoughby
jeanne_stuart	jeanne_stuart
noname_jane	noname_jane
omi_minami	omi_minami
chisato_morishita	chisato_morishita
tong_dawei	tong_dawei
silas_carson	silas_carson
charlie_hall_(actor)	charlie_hall_(actor)
bolo_yeung	bolo_yeung
april_flowers	april_flowers
ben_english	ben_english
daisy_marie	daisy_marie
gong_li	gong_li
david_thwaites	david_thwaites
raul_cristian	raul_cristian
kanako_mitsuhashi	kanako_mitsuhashi
abigail_clayton	abigail_clayton
samuel_hui	samuel_hui
gloria_yip	gloria_yip
kary_ng	kary_ng
john_nettleton_(actor)	john_nettleton_(actor)
brook_williams	brook_williams
johan_ulveson	johan_ulveson
hubert_gregg	hubert_gregg
max_hardcore	max_hardcore
pang_ho-cheung	pang_ho-cheung
gianna_michaels	gianna_michaels
david_weatherley	david_weatherley
reginald_bach	reginald_bach
mari_possa	mari_possa
paul_jesson	paul_jesson
annie_sprinkle	annie_sprinkle
robert_hirsch_(actor)	robert_hirsch_(actor)
sheila_chan	sheila_chan
roman_heart	roman_heart
fan_bingbing	fan_bingbing
sammy_leung	sammy_leung
beatrice_pons	beatrice_pons
daniel_emilfork	daniel_emilfork
naomi_nagasawa	naomi_nagasawa
princess_donna	princess_donna
andrew_pleavin	andrew_pleavin
john_lone	john_lone
kunihiko_yasui	kunihiko_yasui
alain_cuny	alain_cuny
paul_colline	paul_colline
huo_siyan	huo_siyan
hollie-jay_bowes	hollie-jay_bowes
danson_tang	danson_tang
lil_terselius	lil_terselius
don_knight_(actor)	don_knight_(actor)
andy_hui	andy_hui
johnny_hazzard	johnny_hazzard
masao_shimizu	masao_shimizu
pia_degermark	pia_degermark
trinity_loren	trinity_loren
takahiro_tamura	takahiro_tamura
minase_yashiro	minase_yashiro
tony_d'amario	tony_d'amario
jan-olof_strandberg	jan-olof_strandberg
shauna_macdonald	shauna_macdonald
henry_krauss	henry_krauss
lauderdale_maitland	lauderdale_maitland
michael_anderson,_jr.	michael_anderson,_jr.
james_deen	james_deen
billy_herrington	billy_herrington
leon_lai	leon_lai
alec_b._francis	alec_b._francis
fred_cheng	fred_cheng
cherie_chung	cherie_chung
douglas_simmonds	douglas_simmonds
wayne_lai	wayne_lai
marta_romero	marta_romero
sharon_chan	sharon_chan
tina_cheri	tina_cheri
hugh_buckler	hugh_buckler
john_ryder_(actor)	john_ryder_(actor)
kristen_bjorn	kristen_bjorn
steven_cheung_(actor)	steven_cheung_(actor)
rose_stradner	rose_stradner
chiu_chi-ling	chiu_chi-ling
michel_auclair	michel_auclair
ludmilla_radchenko	ludmilla_radchenko
joseph_caillot	joseph_caillot
kotaro_koizumi	kotaro_koizumi
tom_byron	tom_byron
hampe_faustman	hampe_faustman
shigeru_muroi	shigeru_muroi
helen_rowland_(actress)	helen_rowland_(actress)
lee_sheung-ching	lee_sheung-ching
elvis_tsui	elvis_tsui
shun_sugata	shun_sugata
zhang_jin	zhang_jin
liz_edmiston	liz_edmiston
marguerite_de_morlaye	marguerite_de_morlaye
huang_wenyong	huang_wenyong
karen_mok	karen_mok
faye_wong	faye_wong
ivy_chen	ivy_chen
nobuo_kaneko	nobuo_kaneko
henry_o	henry_o
anita_mui	anita_mui
li_yuchun	li_yuchun
william_so	william_so
roger_kwok	roger_kwok
rob_rotten	rob_rotten
adolf_jahr	adolf_jahr
feng_xiaogang	feng_xiaogang
mark_lui	mark_lui
peter_penry-jones	peter_penry-jones
matthew_ko	matthew_ko
sarah-jane_potts	sarah-jane_potts
annie_liu	annie_liu
sadako_sawamura	sadako_sawamura
kayo_matsuo	kayo_matsuo
jacques_legras	jacques_legras
jean_le_poulain	jean_le_poulain
carter_stevens	carter_stevens
qin_yi	qin_yi
johnny_sekka	johnny_sekka
edmund_chen	edmund_chen
kira_kener	kira_kener
roddy_maude-roxby	roddy_maude-roxby
lo_lieh	lo_lieh
ning_jing	ning_jing
shelagh_fraser	shelagh_fraser
jade_ramsey	jade_ramsey
selena_tan	selena_tan
andy_on	andy_on
stanley_logan	stanley_logan
kaori_(voice_actress)	kaori_(voice_actress)
jay_chou	jay_chou
ami_ayukawa	ami_ayukawa
tyler_faith	tyler_faith
tommy_hansen	tommy_hansen
kevin_brennan_(actor)	kevin_brennan_(actor)
pierre_bellemare	pierre_bellemare
tera_patrick	tera_patrick
hilton_edwards	hilton_edwards
jinpachi_nezu	jinpachi_nezu
aimee-ffion_edwards	aimee-ffion_edwards
alexander_fu_sheng	alexander_fu_sheng
david_horovitch	david_horovitch
maggie_cheung	maggie_cheung
nathalie_lunghi	nathalie_lunghi
kanako_sakai	kanako_sakai
julie_cox	julie_cox
zhang_yang_(director)	zhang_yang_(director)
sven_holmberg	sven_holmberg
kitten_natividad	kitten_natividad
sally_rogers	sally_rogers
linzi_drew	linzi_drew
sandra_payne	sandra_payne
terri_kwan	terri_kwan
winston_chao	winston_chao
hou_hsiao-hsien	hou_hsiao-hsien
emmanuel_mouret	emmanuel_mouret
sanae_takagi	sanae_takagi
barry_howard	barry_howard
colette_ripert	colette_ripert
diana_davies_(actress)	diana_davies_(actress)
derek_kok	derek_kok
wong_li-lin	wong_li-lin
rita_faltoyano	rita_faltoyano
karen_mayo-chandler	karen_mayo-chandler
gordon_liu	gordon_liu
rumiko_ukai	rumiko_ukai
ann-sofie_kylin	ann-sofie_kylin
dru_berrymore	dru_berrymore
ana_mulvoy-ten	ana_mulvoy-ten
ben_webster_(actor)	ben_webster_(actor)
cathryn_bradshaw	cathryn_bradshaw
claude_dampier	claude_dampier
olle_hilding	olle_hilding
derek_tsang	derek_tsang
hjalmar_selander	hjalmar_selander
miki_mizuasa	miki_mizuasa
monika_kaelin	monika_kaelin
andrea_habay	andrea_habay
anders_henrikson	anders_henrikson
masayuki_mori_(actor)	masayuki_mori_(actor)
yoko_tsukasa	yoko_tsukasa
cyndi_wang	cyndi_wang
mavis_fan	mavis_fan
kazuko_yanaga	kazuko_yanaga
jonathon_morris	jonathon_morris
simon_lack	simon_lack
jacques_herlin	jacques_herlin
yam_kim-fai	yam_kim-fai
cheung_tat-ming	cheung_tat-ming
takeshi_miura	takeshi_miura
lars_ekborg	lars_ekborg
dunia_montenegro	dunia_montenegro
ty_lattimore	ty_lattimore
miki_sugimoto	miki_sugimoto
johan_paulik	johan_paulik
lo_mang	lo_mang
nanami_sakuraba	nanami_sakuraba
lux_kassidy	lux_kassidy
jack_kao	jack_kao
nicholas_selby	nicholas_selby
terence_longdon	terence_longdon
mew_azama	mew_azama
katrine_boorman	katrine_boorman
peter_dalle	peter_dalle
breck_stewart	breck_stewart
raghu_babu	raghu_babu
gabriella_hall	gabriella_hall
mona_malm	mona_malm
brian_surewood	brian_surewood
mado_maurin	mado_maurin
kaoru_fujino	kaoru_fujino
torgny_anderberg	torgny_anderberg
donnelly_rhodes	donnelly_rhodes
marie_ault	marie_ault
michelle_chia	michelle_chia
don_li	don_li
janice_man	janice_man
charlie_young_(actress)	charlie_young_(actress)
sandra_ng	sandra_ng
georg_adelly	georg_adelly
merle_tottenham	merle_tottenham
pierre_palmade	pierre_palmade
bernard_musson	bernard_musson
liu_xiaoqing	liu_xiaoqing
saya_misaki	saya_misaki
patricia_plunkett	patricia_plunkett
bai_ling	bai_ling
anne_heung	anne_heung
fumie_hosokawa	fumie_hosokawa
jacques_pills	jacques_pills
roy_emerton	roy_emerton
masami_horiuchi	masami_horiuchi
eric_christmas	eric_christmas
chasey_lain	chasey_lain
mitsuko_mori	mitsuko_mori
harry_locke	harry_locke
zhang_ruifang	zhang_ruifang
naoki_yanagi	naoki_yanagi
carl_billquist	carl_billquist
wylie_watson	wylie_watson
liu_tao	liu_tao
eri_ishida	eri_ishida
henry_thia	henry_thia
clive_morton	clive_morton
yoyo_chen	yoyo_chen
gerald_fielding	gerald_fielding
jiro_wang	jiro_wang
tiffany_clark	tiffany_clark
rebecca_lord	rebecca_lord
harry_s._morgan	harry_s._morgan
michael_wong_(actor)	michael_wong_(actor)
olivier_marchal	olivier_marchal
carina_lau	carina_lau
nicolas_bedos	nicolas_bedos
ayumi_beppu	ayumi_beppu
peter_ho	peter_ho
teresa_cheung_(actress)	teresa_cheung_(actress)
angela_glynne	angela_glynne
carmen_chaplin	carmen_chaplin
david_chiang	david_chiang
sheila_raynor	sheila_raynor
aurora_snow	aurora_snow
paul_faivre	paul_faivre
misa_uehara_(actress,_born_1937)	misa_uehara_(actress,_born_1937)
katsunosuke_hori	katsunosuke_hori
stephen_au	stephen_au
edna_best	edna_best
james_culliford	james_culliford
dominic_lam	dominic_lam
nat_ho	nat_ho
steven_o'donnell_(actor)	steven_o'donnell_(actor)
barry_mackay_(actor)	barry_mackay_(actor)
nozomu_sasaki	nozomu_sasaki
essy_persson	essy_persson
kingone_wang	kingone_wang
ayumi_shigemori	ayumi_shigemori
alisha_klass	alisha_klass
danny_mountain	danny_mountain
cameron_jackson	cameron_jackson
debbie_rush	debbie_rush
bambi_woods	bambi_woods
eric_tsang	eric_tsang
lesley_brook	lesley_brook
lena_nyman	lena_nyman
louisa_moritz	louisa_moritz
gerd_andersson	gerd_andersson
fukumi_kuroda	fukumi_kuroda
heron_carvic	heron_carvic
eileen_yeow	eileen_yeow
shinobu_otake	shinobu_otake
joyce_tang	joyce_tang
takeshi_watabe	takeshi_watabe
hisaya_morishige	hisaya_morishige
roxane_duran	roxane_duran
wang_yan_(actress)	wang_yan_(actress)
marcelle_praince	marcelle_praince
shinji_kawada	shinji_kawada
savanna_samson	savanna_samson
clare-hope_ashitey	clare-hope_ashitey
darry_cowl	darry_cowl
carmella_bing	carmella_bing
