finisterre_range	finisterre_range
mount_barnard	mount_barnard
monte_tombea	monte_tombea
champagne_castle	champagne_castle
rocky_peak_ridge	rocky_peak_ridge
monte_negrino	monte_negrino
kirigalpoththa	kirigalpoththa
antichasia	antichasia
mount_takahe	mount_takahe
breidablik_peak	breidablik_peak
monte_pizzocolo	monte_pizzocolo
mastaunspitze	mastaunspitze
skurven	skurven
bakke_mountain	bakke_mountain
academia_peak	academia_peak
pizzo_camino	pizzo_camino
mount_salisbury	mount_salisbury
mount_nebo_(utah)	wasatch_range
dreischusterspitze	dreischusterspitze
clements_mountain	clements_mountain
pointe_allobrogia	pointe_allobrogia
mount_ikeda	mount_ikeda
pic_morto	pic_morto
storefjellsnuten	storefjellsnuten
mabla_mountains	mabla_mountains
tooth_of_time	tooth_of_time
hogg_rock	hogg_rock
mount_kaplan	mount_kaplan
piz_tremoggia	piz_tremoggia
mount_stromlo	mount_stromlo
pen_twyn_mawr	pen_twyn_mawr
tejon_pass	tejon_pass
storebottskarvet	storebottskarvet
hoher_dachstein	hoher_dachstein
middle_teton	middle_teton
golmberg	golmberg
olkhovy_volcanic_group	olkhovy_volcanic_group
kuchela_dhura	kuchela_dhura
monte_argentera	monte_argentera
rambler_peak	rambler_peak
marzellspitze	marzellspitze
alanngorsuaq	alanngorsuaq
kleiner_knollen	kleiner_knollen
chapman_peak	chapman_peak
chapman_peak	vulture_peak_(montana)
mont_brome	mont_brome
matagalls	matagalls
korosi	korosi
bortelhorn	bortelhorn
faliesi	faliesi
snow_lake_peak	snow_lake_peak
fil_kush	fil_kush
fishers_gap	fishers_gap
mount_moran	mount_moran
achalm	eckerich_(fritzlar)
doi_mae_salong	doi_mae_salong
tochal	tochal
rumdoodle_peak	rumdoodle_peak
tenzing_peak	tenzing_peak
tsitika_mountain	tsitika_mountain
mount_redfield	mount_redfield
spina_di_gualdo	spina_di_gualdo
falketind	falketind
hoye-crest	hoye-crest
tamborine_mountain	tamborine_mountain
corndon_hill	corndon_hill
mount_belford	mount_belford
alluitz	alluitz
waterrock_knob	waterrock_knob
cerro_san_luis_obispo	cerro_san_luis_obispo
angna_mountain	angna_mountain
walshs_pyramid	walshs_pyramid
patscher_spitze	patscher_spitze
lion_rock	lion_rock
monte_altissimo	monte_altissimo
chicoma_mountain	chicoma_mountain
guilleries	guilleries
smolikas	smolikas
kirchlespitz	kirchlespitz
puig_cornador_(les_llosses)	puig_cornador_(les_llosses)
seongaksan	seongaksan
jabal_siji	jabal_siji
scotts_mountain	scotts_mountain
rushan_range	rushan_range
rappenstein	rappenstein
baruntse	baruntse
mount_disappointment_(california)	mount_disappointment_(california)
nanda_ghunti	nanda_ghunti
mcclintock_peak	mcclintock_peak
tal_y_fan	tal_y_fan
mount_haig-brown	mount_haig-brown
sant_corneli	sant_corneli
grand_mogul	grand_mogul
kuczaba	kuczaba
aiguille_du_dru	aiguille_du_dru
pointe_de_miribel	pointe_de_miribel
camoscellahorn	camoscellahorn
buruntza	buruntza
kithairon	kithairon
sant_roc_d'amer	sant_roc_d'amer
cerro_petaca	cerro_petaca
testa_grigia	testa_grigia
cumberland_mountains	cumberland_mountains
caldera_del_atuel	caldera_del_atuel
mount_ilas_mapulu	mount_ilas_mapulu
golyam_perelik	golyam_perelik
slieve_binnian	slieve_binnian
furgghorn	furgghorn
colonial_peak	colonial_peak
cracker_(benchmark)	cracker_(benchmark)
jabal_al_habil	jabal_al_habil
traverse_peak	traverse_peak
monte_viso	monte_viso
cima_dello_stagn	cima_dello_stagn
aiguille_des_glaciers	aiguille_des_glaciers
mcdowell_peak	mcdowell_peak
buinaca	buinaca
gamsgrat	gamsgrat
phetchabun_mountains	phetchabun_mountains
watchtower_peak	watchtower_peak
mount_chamah	mount_chamah
kippure	kippure
cime_di_caronella	cime_di_caronella
mount_tekari	mount_tekari
dome_peak	dome_peak
menoikio	menoikio
bad_marriage_mountain	bad_marriage_mountain
karren	karren
monte_caruso	monte_caruso
farnsworth_peak	farnsworth_peak
wilseder_berg	wilseder_berg
quandary_peak	quandary_peak
grohmannspitze	grohmannspitze
carrick_mountain	carrick_mountain
natoas_peak	natoas_peak
adrar_des_ifoghas	adrar_des_ifoghas
varbitsa_pass	varbitsa_pass
waqshash	waqshash
glockenkarkopf	glockenkarkopf
monte_cornagera	monte_cornagera
mount_tsubakuro	mount_tsubakuro
kalenica	kalenica
monte_loffa	monte_loffa
glen_coe	glen_coe
na_gruagaichean	na_gruagaichean
eldorado_mountain	eldorado_mountain
big_spencer_mountain	big_spencer_mountain
slieve_muck	slieve_muck
echo_mountain	echo_mountain
monte_cavallino	monte_cavallino
folarskardnuten	folarskardnuten
butser_hill	butser_hill
hintere_eggenspitze	hintere_eggenspitze
mount_toby	mount_toby
grenzgipfel	grenzgipfel
sleepy_creek_mountain	sleepy_creek_mountain
cima_dei_preti	cima_dei_preti
mount_adrian	mount_adrian
mount_tahat	mount_tahat
great_north_mountain	great_north_mountain
mount_tahan	mount_tahan
mount_mckelvie	mount_mckelvie
macomb_mountain	macomb_mountain
waddon_hill	waddon_hill
daedunsan	daedunsan
mount_pelion_east	mount_pelion_east
faksebrennkollene	faksebrennkollene
nanda_kot	nanda_kot
mount_lawit	mount_lawit
mount_mirador	mount_mirador
seven_utes_mountain	seven_utes_mountain
tetas_de_maria_guevara	tetas_de_maria_guevara
trans-alay_range	trans-alay_range
bartlett_haystack	bartlett_haystack
yokun_ridge	yokun_ridge
mount_ainslie	mount_ainslie
visoki_kurji_vrh	visoki_kurji_vrh
oakzanita_peak	oakzanita_peak
aso_rock	aso_rock
croce_di_monte_bove	croce_di_monte_bove
loon_mountain	loon_mountain
geitryggen	geitryggen
puncak_mandala	puncak_mandala
norton_peak	norton_peak
pizzo_bianco	pizzo_bianco
kearsarge_north	kearsarge_north
monte_cresto	monte_cresto
cilician_gates	cilician_gates
foostock	foostock
cerro_duida	cerro_duida
arlington_mountain	arlington_mountain
el_piveto_mountain	el_piveto_mountain
taboche	taboche
mohokos	mohokos
hirmentaz	hirmentaz
shavers_fork_mountain_complex	shavers_fork_mountain_complex
mount_borodin	mount_borodin
lukttinden	lukttinden
meall_a'_chrasgaidh	meall_a'_chrasgaidh
pizzo_scalino	pizzo_scalino
krakatoa	krakatoa
monte_vioz	monte_vioz
huntington_ravine	huntington_ravine
white_cloud_peak_1	white_cloud_peak_1
aqupallqa	aqupallqa
aiguille_de_scolette	aiguille_de_scolette
white_cloud_peak_2	white_cloud_peak_2
jabal_ghulayyil_khun	jabal_ghulayyil_khun
white_cloud_peak_3	white_cloud_peak_3
white_cloud_peak_4	white_cloud_peak_4
white_cloud_peak_5	white_cloud_peak_5
white_cloud_peak_6	white_cloud_peak_6
white_cloud_peak_7	white_cloud_peak_7
mount_dickerson	mount_dickerson
white_cloud_peak_8	white_cloud_peak_8
white_cloud_peak_9	white_cloud_peak_9
pyramidenkogel	pyramidenkogel
massiccio_del_sirino	massiccio_del_sirino
crook_hill	crook_hill
hocheisspitze	hocheisspitze
san_rafael_reef	san_rafael_reef
auf_dem_acker	auf_dem_acker
nyamuragira	nyamuragira
tomaros	tomaros
schaffenaker_mountain	schaffenaker_mountain
berry_mountain	berry_mountain
suli_top	suli_top
mount_alayta	mount_alayta
eggardon_hill	eggardon_hill
islay_hill	islay_hill
snowmass_mountain	snowmass_mountain
dari_ovoo	dari_ovoo
adelbert_range	adelbert_range
viskyar_ridge	viskyar_ridge
outlook_peak	outlook_peak
dent_d'oche	dent_d'oche
noijin_kangsang	noijin_kangsang
shiliin_bogd	shiliin_bogd
mount_yamantau	mount_yamantau
chamlang	chamlang
cima_viola	cima_viola
kala_patthar	kala_patthar
monte_padrio	monte_padrio
white_carpathians	white_carpathians
tschenglser_hochwand	tschenglser_hochwand
monte_pracaban	monte_pracaban
pointe_de_chalune	pointe_de_chalune
hoemunsan	hoemunsan
jabal_janubi	jabal_janubi
raggsteinnuten	raggsteinnuten
roc_de_frausa	roc_de_frausa
tossa_plana_de_lles	tossa_plana_de_lles
botzer	botzer
barbeau_peak	barbeau_peak
sas_dla_crusc	sas_dla_crusc
rocky_peak	rocky_peak
wolfskopf	wolfskopf
monte_grappa	monte_grappa
gorllwyn	gorllwyn
chief_mountain	chief_mountain
toney_mountain	toney_mountain
mount_race	mount_race
poncione_di_ganna	poncione_di_ganna
pizzo_cassandra	pizzo_cassandra
leroboleng	leroboleng
mount_islip	mount_islip
southern_yatsugatake_volcanic_group	southern_yatsugatake_volcanic_group
mambilla_plateau	mambilla_plateau
galician_massif	galician_massif
bindon_hill	bindon_hill
dehnenkopf	dehnenkopf
texelspitze	texelspitze
citadel_mountain	citadel_mountain
sentinel_dome	sentinel_dome
right_angle_peak	right_angle_peak
jabal_ruwaydah	jabal_ruwaydah
cerro_el_sol	cerro_el_sol
steins_peak	steins_peak
slievemaan	slievemaan
snoqualmie_mountain	snoqualmie_mountain
dardanelles_cone	dardanelles_cone
mojstrovica	mojstrovica
mount_cabot	mount_cabot
san_emigdio_mountain	san_emigdio_mountain
mount_thule	mount_thule
khao_luang	khao_luang
monte_berlinghera	monte_berlinghera
mount_eisenhower	mount_eisenhower
vourinos	vourinos
cima_del_fop	cima_del_fop
ortler	ortler
chatsworth_peak	chatsworth_peak
monte_ponteranica	monte_ponteranica
ailama	ailama
carihuairazo	carihuairazo
eastern_sudetes	eastern_sudetes
mola_del_guerxet	mola_del_guerxet
hot_springs_mountain	hot_springs_mountain
thalay_sagar	thalay_sagar
mount_supernal	mount_supernal
mount_dama_ali	mount_dama_ali
fissenkenkopf	fissenkenkopf
baron_peak	baron_peak
pizzo_del_diavolo_di_tenda	pizzo_del_diavolo_di_tenda
serra_d'esparreguera	serra_d'esparreguera
rinnerspitz	rinnerspitz
monte_guglielmo	monte_guglielmo
maja_harapit	maja_harapit
imun	imun
roteck	roteck
grande_balmaz	grande_balmaz
imuruk_lake_volcanic_field	imuruk_lake_volcanic_field
mount_harmston	mount_harmston
sinopah_mountain	sinopah_mountain
tossal_gros_de_vallbona	tossal_gros_de_vallbona
mount_barney	mount_barney
les_agudes	les_agudes
grieshorn	grieshorn
la_singla	la_singla
baffin_mountains	baffin_mountains
junction_peak	junction_peak
shavers_mountain	shavers_mountain
mount_battle	mount_battle
cerro_bonete	cerro_bonete
temple_crag	temple_crag
tuzovsky	tuzovsky
sublett_range_high_point	sublett_range_high_point
pizzo_di_rodes	pizzo_di_rodes
jonsknuten	jonsknuten
kholeno	kholeno
mount_massive	mount_massive
vitinya_pass	vitinya_pass
eisenerzer_reichenstein	eisenerzer_reichenstein
talking_mountain	talking_mountain
sandstone_peak	sandstone_peak
mount_lofty	mount_lofty
great_sugar_loaf	great_sugar_loaf
morral_de_cabrafeixet	morral_de_cabrafeixet
mount_calowahcan	mount_calowahcan
mount_isolation	mount_isolation
slipdown_mountain	slipdown_mountain
kamarkawarai-tepui	kamarkawarai-tepui
cornettes_de_bise	cornettes_de_bise
royal_society_range	royal_society_range
kookooligit_mountains	kookooligit_mountains
jutland_mountain	jutland_mountain
puig_cornador_(ribes_de_freser)	puig_cornador_(ribes_de_freser)
nevado_juncal	nevado_juncal
puig_de_bassegoda	puig_de_bassegoda
phawngpui	phawngpui
pico_el_toro	pico_el_toro
ludlow_mountain	ludlow_mountain
pasochoa	pasochoa
marble_mountain-trout_creek_hill	marble_mountain-trout_creek_hill
mount_hoffmann	mount_hoffmann
pico_do_barbado	pico_do_barbado
mount_keen	mount_keen
clachnaben	clachnaben
mount_tutoko	mount_tutoko
sevy_peak	sevy_peak
monte_tesoro	monte_tesoro
lower_wolfjaw_mountain	lower_wolfjaw_mountain
djouce	djouce
pizzo_ligoncio	pizzo_ligoncio
punta_de_la_torroja	punta_de_la_torroja
creigiau_gleision	creigiau_gleision
dunderberg_peak	dunderberg_peak
napasorsuaq	napasorsuaq
mount_asgard	mount_asgard
la_faiada	la_faiada
mount_septimus	mount_septimus
carnedd_llewelyn	carnedd_llewelyn
horstmann_peak	horstmann_peak
mount_satima	mount_satima
anboto	anboto
didi_abuli	didi_abuli
mount_romeo	mount_romeo
mount_tujuh	mount_tujuh
carrizozo_volcanic_field	carrizozo_volcanic_field
smarts_mountain	smarts_mountain
karaha_crater	karaha_crater
galinakopf	galinakopf
pizzo_recastello	pizzo_recastello
bastiments	bastiments
monte_carmo	monte_carmo
garsellakopf	garsellakopf
mount_coe	mount_coe
grand_pilier_d'angle	grand_pilier_d'angle
mount_kaikoma	mount_kaikoma
elliott_knob	elliott_knob
newhall_pass	newhall_pass
mawhpung_bum	mawhpung_bum
smiths_hill	smiths_hill
bitterroot_range	bitterroot_range
carrauntoohil	carrauntoohil
ukpik_peak	ukpik_peak
midtre_hellstugutinden	midtre_hellstugutinden
inielika	inielika
cerro_avispa	cerro_avispa
cerro_torre	cerro_torre
tharpu_chuli	tharpu_chuli
bandarpunch	bandarpunch
augustine_volcano	augustine_volcano
monte_bisbino	monte_bisbino
panachaiko	panachaiko
awkiwatu	awkiwatu
laugenspitze	laugenspitze
golets-torny_group	golets-torny_group
punta_san_matteo	punta_san_matteo
ingleborough	ingleborough
hochfernerspitze	hochfernerspitze
velebit	velebit
mara_mountain	mara_mountain
kulmi	kulmi
mount_waesche	mount_waesche
cerro_la_luna	cerro_la_luna
kebeney	kebeney
ali_sabieh_mountain	ali_sabieh_mountain
mount_tennent	mount_tennent
storhellernuten	storhellernuten
mont_rougemont	mont_rougemont
grimming	grimming
changabang	changabang
sherburne_peak	sherburne_peak
barkhatnaya_sopka	barkhatnaya_sopka
galgiriya_mountain	galgiriya_mountain
store_bukkeholstinden	store_bukkeholstinden
monte_san_martino_(lecco)	monte_san_martino_(lecco)
guadalupe_hill	guadalupe_hill
pointe_de_barasson	pointe_de_barasson
black_kaweah	black_kaweah
flagstaff_mountain	flagstaff_mountain
pic_de_finestrelles	pic_de_finestrelles
pic_eccles	pic_eccles
ulriken	ulriken
y_foel_goch	y_foel_goch
moyeha_mountain	moyeha_mountain
monte_frerone	monte_frerone
veobrehesten	veobrehesten
mount_kailash	mount_kailash
monte_acellica	monte_acellica
mount_braun	mount_braun
mellomnuten	mellomnuten
redington_pass	redington_pass
saptha_kanya	saptha_kanya
parrotspitze	parrotspitze
pizzo_del_torto	pizzo_del_torto
bazman	bazman
jaizkibel	jaizkibel
pen_bwlch_llandrillo	pen_bwlch_llandrillo
mount_skylight	mount_skylight
geierwand	geierwand
cradle_mountain	cradle_mountain
high_wheeldon	high_wheeldon
puigsacalm_xic	puigsacalm_xic
triple_divide_peak_(montana)	triple_divide_peak_(montana)
beartown_mountain	beartown_mountain
mount_lee	mount_lee
heukseongsan	heukseongsan
mount_whisler	mount_whisler
mont_de_grange	mont_de_grange
sierra_de_utiel	sierra_de_utiel
sierra_del_toro	sierra_del_toro
rasuwillka	rasuwillka
penegal	penegal
murpheys_bluff	murpheys_bluff
abajo_peak	abajo_peak
sierra_de_orihuela	sierra_de_orihuela
beriain	beriain
signalen	signalen
el_far_(cim_de_susqueda)	el_far_(cim_de_susqueda)
mount_choqa	mount_choqa
mount_livadiyskaya	mount_livadiyskaya
hazaran	hazaran
mount_tallac	mount_tallac
mission_peak	mission_peak
cacapon_mountain	cacapon_mountain
iceberg_peak	iceberg_peak
karawanks	karawanks
mount_murud	mount_murud
mount_chittenden	mount_chittenden
sulzfluh	sulzfluh
mount_shavano	mount_shavano
mount_sabyinyo	mount_sabyinyo
griffith_peak	griffith_peak
iliniza_sur	iliniza_sur
mount_gibbs	mount_gibbs
zirbitzkogel	zirbitzkogel
im_hinteren_eis	im_hinteren_eis
mount_iowa	mount_iowa
wasenhorn	wasenhorn
rognhaugen	rognhaugen
polezhan	polezhan
monte_rogoria	monte_rogoria
mount_markham	mount_markham
lavanttal_alps	lavanttal_alps
mount_ayles	mount_ayles
slieve_bearnagh	slieve_bearnagh
mount_cristal	mount_cristal
surtningssue	surtningssue
kalanag	kalanag
vorab	vorab
rocca_dei_tre_vescovi	rocca_dei_tre_vescovi
bogd_khan_mountain	bogd_khan_mountain
craiglich	craiglich
bomber_mountain	bomber_mountain
pen_cerrig-calch	pen_cerrig-calch
aconcagua	aconcagua
putauaki	putauaki
mount_moriarty	mount_moriarty
cima_portule	cima_portule
ipasha_peak	ipasha_peak
lost_arrow_spire	lost_arrow_spire
boott_spur	boott_spur
khao_sam_muk	khao_sam_muk
mount_wilhelm	mount_wilhelm
toppa_pizzuta	toppa_pizzuta
monte_costa_calda	monte_costa_calda
monte_piambello	monte_piambello
monte_spina	monte_spina
hausstock	hausstock
pica_d'estats	pica_d'estats
mont_ham	mont_ham
waun_fach	waun_fach
mount_everts	mount_everts
churchill_mountains	churchill_mountains
petite_aiguille_verte	petite_aiguille_verte
stratenec	stratenec
sasso_del_ferro	sasso_del_ferro
monte_san_vicino	monte_san_vicino
ngadi_chuli	ngadi_chuli
wayang-windu	wayang-windu
greycap	greycap
thornton_gap	thornton_gap
bridge_mountain	bridge_mountain
norman_clyde_peak	norman_clyde_peak
tuckettspitze	tuckettspitze
gangcheonsan	gangcheonsan
cima_valdritta	cima_valdritta
mount_marathon	mount_marathon
borden_mountain	borden_mountain
leutongey	leutongey
mount_mohican	mount_mohican
cima_de_barna	cima_de_barna
cape_mountain	cape_mountain
slaughter_mountain	slaughter_mountain
monte_san_primo	monte_san_primo
tirsuli	tirsuli
monte_lema	monte_lema
zograf_peak	zograf_peak
mount_finlayson	mount_finlayson
tyrvlesnuten	tyrvlesnuten
kniebrink	kniebrink
paramillo_massif	paramillo_massif
piz_sella	piz_sella
sierra_nevada_de_santa_marta	sierra_nevada_de_santa_marta
parkhouse_hill	parkhouse_hill
lysebottnuten	lysebottnuten
breiliflaka	breiliflaka
nubble_peak	nubble_peak
sangeang_api	sangeang_api
thunderhead_mountain	thunderhead_mountain
geraneia	geraneia
owen_stanley_range	owen_stanley_range
snjoheinuten	snjoheinuten
ironstone_mountain	ironstone_mountain
johannesburg_mountain	johannesburg_mountain
takur_ghar	takur_ghar
whernside	whernside
monte_litto	monte_litto
monte_orsiera	monte_orsiera
devils_thumb	devils_thumb
balerdi	balerdi
winterstock	winterstock
sekincau_belirang	sekincau_belirang
mount_murphy	mount_murphy
pizzo_tre_signori	corno_zuccone
pizzo_tre_signori	pizzo_tre_signori
mount_everett	mount_everett
cleeve_hill	cleeve_hill
mjuken	mjuken
volanuten	volanuten
corna_trentapassi	corna_trentapassi
static_peak	static_peak
thotupola_kanda	thotupola_kanda
tomle	tomle
byeonsan	byeonsan
mount_takht-e_suleyman	mount_takht-e_suleyman
bote_mountain	bote_mountain
pico_bonpland	pico_bonpland
tsemperou	tsemperou
tosseta_rasa	tosseta_rasa
drygarn_fawr	drygarn_fawr
mount_heyburn	mount_heyburn
mount_everest	mount_everest
mount_stanford	mount_stanford
mount_ena	mount_ena
st_mary_peak	st_mary_peak
stucklistock	stucklistock
mount_palmerston	mount_palmerston
hohe_dock	hohe_dock
haugan_mountain	haugan_mountain
jabal_thayb	jabal_thayb
rocciamelone	rocciamelone
bishop_wilton_wold	bishop_wilton_wold
garbh_bheinn	garbh_bheinn
yamsay_mountain	yamsay_mountain
skrimfjella	skrimfjella
pico_da_neblina	pico_da_neblina
les_grandes_otanes	les_grandes_otanes
mount_williamson	mount_williamson
funtenseetauern	funtenseetauern
monte_chierico	monte_chierico
mount_antero	mount_antero
costabona	costabona
store_austanbotntind	store_austanbotntind
fajada_butte	fajada_butte
mount_woodrow_wilson	mount_woodrow_wilson
zeller_horn	zeller_horn
breiteberg	monumentberg
mount_juneau	mount_juneau
saddle_ball_mountain	saddle_ball_mountain
marias_pass	marias_pass
petit_encantat	petit_encantat
am_bodach	am_bodach
montdois	montdois
caherconree	caherconree
hoher_tenn	hoher_tenn
stanage_edge	stanage_edge
mount_regina	mount_regina
agassiz_peak	agassiz_peak
mount_roraima	mount_roraima
jebel_kelti	jebel_kelti
zumsteinspitze	zumsteinspitze
karjiang	karjiang
mount_pelly	mount_pelly
oksskolten	oksskolten
williamsburg_mountain	williamsburg_mountain
phipps_peak	phipps_peak
avalanche_spire	avalanche_spire
blackstone_edge	blackstone_edge
braddock_peak	braddock_peak
frankland_peak	frankland_peak
pic_de_costa_cabirolera	pic_de_costa_cabirolera
barangsan	barangsan
cerro_huachamacari	cerro_huachamacari
semnoz	semnoz
hertali	hertali
big_boy_peak	big_boy_peak
pico_do_jabre	pico_do_jabre
vetter_mountain	vetter_mountain
annapurna	annapurna
north_palisade	north_palisade
lusatian_mountains	lusatian_mountains
stripe_mountain	stripe_mountain
grassengrat	grassengrat
cheat_mountain	cheat_mountain
torghatten	torghatten
kleiner_mythen	kleiner_mythen
mistberget	mistberget
botev_peak	botev_peak
puesto_cortaderas	puesto_cortaderas
monte_campomolon	monte_campomolon
monteixo	monteixo
rocallarga	rocallarga
urdevassfjell	urdevassfjell
dong_ap_bia	dong_ap_bia
croscat	croscat
battlement_mountain	battlement_mountain
portjengrat	portjengrat
roca_de_la_feixa	roca_de_la_feixa
mount_burnham	mount_burnham
pizzo_della_croce	pizzo_della_croce
vikerfjell	vikerfjell
skimtheia	skimtheia
mafadi	mafadi
mount_eugene	mount_eugene
loloru	loloru
gross_seehorn	gross_seehorn
fort_rock	fort_rock
punta_tre_vescovi	punta_tre_vescovi
blackfoot_mountain	blackfoot_mountain
balkan_mountains	balkan_mountains
matterhorn	matterhorn
monte_masoni	monte_masoni
jazzihorn	jazzihorn
greenleaf_peak	greenleaf_peak
sandfloegga	sandfloegga
culver_ridge	culver_ridge
loddo	loddo
martschenspitz	martschenspitz
mont_tondu	mont_tondu
mount_blackburn	mount_blackburn
alpspitz	alpspitz
mount_edwards	mount_edwards
filsenberg	kinzert
stob_binnein	stob_binnein
cerro_el_toro	cerro_el_toro
algonquin_peak	algonquin_peak
hermannsdalstinden	hermannsdalstinden
echo_peak	echo_peak
jabal_jabsah	jabal_jabsah
hambledon_hill	hambledon_hill
camas_county_highpoint	camas_county_highpoint
beinn_fhada	beinn_fhada
varnous	varnous
skorpetindene	skorpetindene
maisan	maisan
krndija	krndija
sticht_range	sticht_range
pizzo_groppera	pizzo_groppera
monte_leco	monte_leco
veleka_ridge	veleka_ridge
fan_fraith	fan_fraith
monte_nerone	monte_nerone
nordklofjellet	nordklofjellet
cerro_aracamuni	cerro_aracamuni
denny_mountain	denny_mountain
brennhaugen	brennhaugen
kesselkogel	kesselkogel
khao_chang	khao_chang
gyrn_wigau	gyrn_wigau
txindoki	txindoki
mount_colden	mount_colden
upuigma-tepui	upuigma-tepui
mount_mary_austin	mount_mary_austin
kongur_tagh	kongur_tagh
thamserku	thamserku
sirretta_peak	sirretta_peak
rauberflaket	rauberflaket
haferberg	haferberg
sudetes	sudetes
sourland_mountain	sourland_mountain
bregenz_forest_mountains	bregenz_forest_mountains
naafkopf	naafkopf
ngga_pulu	ngga_pulu
arrei_mountains	arrei_mountains
white_calf_mountain	white_calf_mountain
mount_timpanogos	mount_timpanogos
monte_ricco	monte_ricco
titus_peak	titus_peak
torc_mountain	torc_mountain
mount_brandon	mount_brandon
challenger_point	challenger_point
foel_cwmcerwyn	foel_cwmcerwyn
mount_celeste	mount_celeste
langtauferer_spitze	langtauferer_spitze
xuelian_feng	xuelian_feng
piz_costainas	piz_costainas
kahiltna_peaks	kahiltna_peaks
jabal_al_kubus	jabal_al_kubus
mount_batu	mount_batu
cho_polu	cho_polu
trafoier_eiswand	trafoier_eiswand
scharteberg	scharteberg
cimone_della_bagozza	cimone_della_bagozza
chiunzi	chiunzi
moel_sych	moel_sych
shadow_peak	shadow_peak
fionn_bheinn	fionn_bheinn
parnitha	parnitha
ras_dashen	ras_dashen
moel_yr_ogof	moel_yr_ogof
mount_kirigamine	mount_kirigamine
ajo_peak	ajo_peak
chilgapsan	chilgapsan
whiltilla_mountain	whiltilla_mountain
corno_stella	corno_stella
hawk_mountain	hawk_mountain
hofmahdjoch	hofmahdjoch
oshie_ridge	oshie_ridge
commonwealth_mountain	commonwealth_mountain
mount_alston	mount_alston
gile_mountain	gile_mountain
mount_bintuod	mount_bintuod
sierra_de_callosa	sierra_de_callosa
shelburne_moriah_mountain	shelburne_moriah_mountain
movri	movri
el_capitan	el_capitan
bukit_batu_lawi	bukit_batu_lawi
north_river_mountain	north_river_mountain
mount_index	mount_index
puig_de_pastuira	puig_de_pastuira
redhorn_peak	redhorn_peak
cap_de_boumort	cap_de_boumort
manassas_gap	manassas_gap
shishel	shishel
basque_mountains	basque_mountains
apikuni_mountain	apikuni_mountain
ivao_group	ivao_group
chandrashila	chandrashila
methodist_mountain	methodist_mountain
abiathar_peak	abiathar_peak
jomolhari	jomolhari
moel_siabod	moel_siabod
voyampolsky	voyampolsky
singu_chuli	singu_chuli
doi_phi_pan_nam	doi_phi_pan_nam
almost-a-dog_mountain	almost-a-dog_mountain
doi_chiang_dao	doi_chiang_dao
montsent_de_pallars	montsent_de_pallars
hoher_ifen	hoher_ifen
mount_tapulao	mount_tapulao
mount_utsugi	mount_utsugi
ofenhorn	ofenhorn
henry's_fork_caldera	henry's_fork_caldera
dagouein_mountain	dagouein_mountain
mount_mohepinoke	mount_mohepinoke
mount_coonowrin	mount_coonowrin
croda_da_lago	croda_da_lago
knobly_mountain	knobly_mountain
schesaplana	schesaplana
mount_baya	mount_baya
wildspitz	wildspitz
couchsachraga_peak	couchsachraga_peak
longridge_fell	longridge_fell
the_jaw	the_jaw
the_wrekin	the_wrekin
attavyros	attavyros
clarks_knob	clarks_knob
rysy	rysy
bear_garden_mountain	bear_garden_mountain
sialan	sialan
kisdon	kisdon
murara	murara
monte_avaro	monte_avaro
kit_hill	kit_hill
mount_waumbek	mount_waumbek
bud_dajo	bud_dajo
serra_de_l'espina	serra_de_l'espina
cerro_ramada	cerro_ramada
fuscherkarkopf	fuscherkarkopf
mount_dallmann	mount_dallmann
spring_gap_mountain	spring_gap_mountain
cuicocha	cuicocha
sustenhorn	sustenhorn
drag_hill	drag_hill
nordliskampen	nordliskampen
mascarin_peak	mascarin_peak
pizz_gallagiun	pizz_gallagiun
swartberg	swartberg
tryfan	tryfan
plosky	plosky
hornindalsrokken	hornindalsrokken
clingmans_dome	clingmans_dome
molacima	molacima
le_linleu	le_linleu
ulugh_muztagh	ulugh_muztagh
petticoat_hill	petticoat_hill
teepe_pillar	teepe_pillar
littles_peak	littles_peak
mount_kelsey	mount_kelsey
keeney_knob	keeney_knob
du_cane_range	du_cane_range
green_lakes_mountain	green_lakes_mountain
amethyst_mountain	amethyst_mountain
pointe_d'anterne	pointe_d'anterne
apelsberg	apelsberg
mount_harker	mount_harker
mount_jackson_(montana)	mount_jackson_(montana)
derwent_edge	derwent_edge
emuruangogolak	emuruangogolak
skjerkenuten	skjerkenuten
mount_lowe_(california)	mount_lowe_(california)
picorandan	picorandan
monte_re_di_castello	monte_re_di_castello
delano_peak	delano_peak
mount_minsi	mount_minsi
kalsubai	kalsubai
cerro_pedernal	cerro_pedernal
sweat_mountain	sweat_mountain
collarada	collarada
uzon	uzon
galenstock	galenstock
monte_vermenone	monte_vermenone
gora_kurumdy	gora_kurumdy
mount_stevenson	mount_stevenson
galdene	galdene
mynydd_graig_goch	mynydd_graig_goch
piz_combul	piz_combul
pointe_des_berons	pointe_des_berons
ndete_napu	ndete_napu
moel_y_parc	moel_y_parc
holyoke_range	holyoke_range
drei_kapuziner	drei_kapuziner
ocate_volcanic_field	ocate_volcanic_field
cima_delle_pozzette	cima_delle_pozzette
pizzo_cavregasco	pizzo_cavregasco
boris_yeltsin_peak	boris_yeltsin_peak
horsepen_mountain	horsepen_mountain
dirfi	dirfi
mount_willey	mount_willey
agnes_mountain	agnes_mountain
corno_dei_tre_signori	corno_dei_tre_signori
cerro_pintado	cerro_pintado
jabal_satif	jabal_satif
baldpate_mountain	baldpate_mountain
mong_ling_shan	mong_ling_shan
bollettone	bollettone
crusc_de_rit	crusc_de_rit
leavitt_peak	leavitt_peak
hawksbill_mountain	hawksbill_mountain
st._michael_volcanic_field	st._michael_volcanic_field
monte_manos	monte_manos
monte_delle_tre_croci	monte_delle_tre_croci
mount_sacagawea	mount_sacagawea
scherbadung	scherbadung
catena_delle_tre_croci	catena_delle_tre_croci
kokummi_mountain	kokummi_mountain
pegunungan_arfak	pegunungan_arfak
greenhorn_mountain	greenhorn_mountain
doom_mountain	doom_mountain
pointe_d'uble	pointe_d'uble
pointe_bayeux	pointe_bayeux
signalkuppe	signalkuppe
mount_wrangell	mount_wrangell
thomas_cole_mountain	thomas_cole_mountain
castleton_tower	castleton_tower
el_coscollet	el_coscollet
mount_limbert	mount_limbert
puncak_jaya	puncak_jaya
south_carter_mountain	south_carter_mountain
boney_peak	boney_peak
piz_trevisina	piz_trevisina
pelican_butte	pelican_butte
dammastock	dammastock
piz_schumbraida	piz_schumbraida
meldrum_mountain	meldrum_mountain
cime_di_lemma	cime_di_lemma
wamp'una	wamp'una
stachlerkopf	stachlerkopf
disappointment_mountain	disappointment_mountain
mickey's_spire	mickey's_spire
secheron_peak	secheron_peak
bear_mountain_(kern_county,_california)	bear_mountain_(kern_county,_california)
moaksan	moaksan
svolhusgreini	svolhusgreini
glocknerwand	glocknerwand
croghan_hill	croghan_hill
thurwieserspitze	thurwieserspitze
monte_sibilla	monte_sibilla
swiftcurrent_mountain	swiftcurrent_mountain
varingskollen	varingskollen
whitewater_baldy	whitewater_baldy
mount_cotter	mount_cotter
victorio_peak	victorio_peak
birkenkofel	birkenkofel
montagna_dei_fiori	montagna_dei_fiori
chester_gap	chester_gap
humphreys_peak	humphreys_peak
nine_peaks	nine_peaks
pollock_mountain	pollock_mountain
monte_sirente	monte_sirente
cresta_di_enghe	cresta_di_enghe
mount_kineo	mount_kineo
mount_sherman	mount_sherman
kharkush_(ghazni)	kharkush
south_mount_hawkins	south_mount_hawkins
san_luis_peak	san_luis_peak
mount_carrigain	mount_carrigain
mount_minamikoma	mount_minamikoma
chisos_mountains	chisos_mountains
giant_mountain	giant_mountain
sumas_mountain	sumas_mountain
hengduan_mountains	hengduan_mountains
levelland_mountain	levelland_mountain
angasima-tepui	angasima-tepui
fineilspitze	fineilspitze
rimutaka_range	rimutaka_range
sveningen	sveningen
warden_peak	warden_peak
belirang-beriti	belirang-beriti
rhos_fawr	rhos_fawr
gobba_di_rollin	gobba_di_rollin
mount_sukaria	mount_sukaria
fallhaugen	fallhaugen
ol_doinyo_eburru	ol_doinyo_eburru
dyulino_pass	dyulino_pass
verkhovoy	verkhovoy
galehead_mountain	galehead_mountain
banner_peak	banner_peak
lewesdon_hill	lewesdon_hill
nathaniel_mountain	nathaniel_mountain
red_rock_mountain	red_rock_mountain
grand_teton	grand_teton
gramos	gramos
pagelsburg	pagelsburg
seekofel	seekofel
mount_tammany	mount_tammany
barrclashcame	barrclashcame
dunraven_peak	dunraven_peak
mount_root	mount_root
lugnaquilla	lugnaquilla
black_tooth_mountain	black_tooth_mountain
corno_zuccone	corno_zuccone
shkhara	shkhara
grassen	grassen
sasso_gordona	sasso_gordona
mount_ilas_bungaan	mount_ilas_bungaan
mount_myra	mount_myra
petrova_gora	petrova_gora
sunday_river_whitecap	sunday_river_whitecap
urataman	urataman
glass_house_mountains	glass_house_mountains
red_butte	red_butte
elidir_fawr	elidir_fawr
sangpang_bum	sangpang_bum
pico_do_papagaio	pico_do_papagaio
khan_tengri	khan_tengri
potomac_water_gap	potomac_water_gap
cathey_peak	cathey_peak
chasia	chasia
mount_gallatin	mount_gallatin
four_craters_lava_field	four_craters_lava_field
doi_phu_kha	doi_phu_kha
mount_tecumseh	mount_tecumseh
brecherspitz	brecherspitz
mount_nimmel	mount_nimmel
duncan's_peak	duncan's_peak
storsteinsfjell	storsteinsfjell
wurzelbrink	wurzelbrink
monte_tredenus	monte_tredenus
twelve_bens	twelve_bens
gu_achi_peak	gu_achi_peak
cima_piazzi	cima_piazzi
macnaughton_mountain	macnaughton_mountain
mount_conness	mount_conness
mourgana	mourgana
little_si	little_si
sant_benet_(susqueda)	sant_benet_(susqueda)
monte_bregagno	monte_bregagno
cima_verosso	cima_verosso
kallidromo	kallidromo
thunder_mountain_(amador_county,_california)	thunder_mountain_(amador_county,_california)
mount_orizaba	mount_orizaba
monte_due_mani	monte_due_mani
squaw_ridge_lava_field	squaw_ridge_lava_field
serra_de_la_mussara	la_mussara_(vilaplana)
serra_de_la_mussara	serra_de_la_mussara
gazzirola	gazzirola
north_arapaho_peak	north_arapaho_peak
appistoki_peak	appistoki_peak
monte_legnone	monte_legnone
monte_legnone	pizzo_groppera
hergest_ridge	hergest_ridge
rockchuck_peak	rockchuck_peak
spruce_knob	spruce_knob
crestone_needle	crestone_needle
hkusam_mountain	hkusam_mountain
brodie_mountain	brodie_mountain
union_pass	union_pass
grenier_de_commune	grenier_de_commune
monte_valletto	monte_valletto
mount_shuksan	mount_shuksan
askio	askio
constantiaberg	constantiaberg
triglav	triglav
piz_bles	piz_bles
lyskamm	lyskamm
monte_cevedale	monte_cevedale
arctic_cordillera	arctic_cordillera
klopaierspitze	klopaierspitze
monte_di_tremezzo	monte_di_tremezzo
central_eastern_alps	central_eastern_alps
tai_mo_shan	tai_mo_shan
caliente_mountain	caliente_mountain
mount_sis	mount_sis
trabuco_peak	trabuco_peak
mount_hight	mount_hight
tung_fort	tung_fort
staccato_peaks	staccato_peaks
portsdown_hill	portsdown_hill
prairie_creek_peak	prairie_creek_peak
mount_hahn	mount_hahn
lovely_seat	lovely_seat
acrodectes_peak	acrodectes_peak
hochstadl	hochstadl
grauspitz	grauspitz
mount_bessan	mount_bessan
mount_elkins	mount_elkins
jabal_muthrad	jabal_muthrad
godor_north_top	godor_north_top
kutschenberg	kutschenberg
thousand_lake_mountain	thousand_lake_mountain
chaudhara	chaudhara
montagne_du_charbon	montagne_du_charbon
loi_leng	loi_leng
sonora_peak	sonora_peak
little_trees_hill	little_trees_hill
the_ercall	the_ercall
goose_eye_mountain	goose_eye_mountain
aizkorri	aizkorri
wollbachspitze	wollbachspitze
santiago_peak	santiago_peak
annamite_range	annamite_range
ramstadslottet	ramstadslottet
upper_wolfjaw_mountain	upper_wolfjaw_mountain
monte_monarco	monte_monarco
hkakabo_razi	hkakabo_razi
bread_loaf_mountain	bread_loaf_mountain
khao_nom_sao	khao_nom_sao
logan_peak	logan_peak
the_cairnwell	the_cairnwell
andes	andes
roca_centella	roca_centella
plana_peak	plana_peak
remsspitze	remsspitze
punta_de_la_barrina	punta_de_la_barrina
honwee_mountain	honwee_mountain
telegrafenberg	telegrafenberg
gaussberg	gaussberg
jabal_mubrahah	jabal_mubrahah
quirauk_mountain	quirauk_mountain
spanish_peaks	spanish_peaks
la_carabassa	la_carabassa
bastion_peak	bastion_peak
mount_donner	mount_donner
rigi	rigi
punta_del_curull	punta_del_curull
kisimngiuqtuq_peak	kisimngiuqtuq_peak
mount_pentelicus	mount_pentelicus
reporoa_caldera	reporoa_caldera
west_crater	west_crater
hinter_grauspitz	hinter_grauspitz
jangansan	jangansan
rundemanen	rundemanen
antofagasta_de_la_sierra	antofagasta_de_la_sierra
piz_dles_cunturines	piz_dles_cunturines
mynydd_tarw	mynydd_tarw
mount_maclure	mount_maclure
zerhoun	zerhoun
west_kill_mountain	west_kill_mountain
gfallwand	gfallwand
pico_peak	pico_peak
presanella	presanella
argus_mountain	argus_mountain
black_balsam_knob	black_balsam_knob
fritzerkogel	fritzerkogel
mount_dainichi	mount_dainichi
cloud_peak	cloud_peak
konzhakovskiy_kamen	konzhakovskiy_kamen
mount_jarvis	mount_jarvis
cornell_mountain	cornell_mountain
buried_mountain	buried_mountain
rocky_butte	rocky_butte
nag_tibba	nag_tibba
mount_orville	mount_orville
wielki_szyszak	wielki_szyszak
bedini_bugyal	bedini_bugyal
monte_leone	monte_leone
te_mata_peak	te_mata_peak
monte_civetta	monte_civetta
fagerfjell	fagerfjell
waun-oer	waun-oer
la_morella	la_morella
little_carpathians	little_carpathians
mount_major	mount_major
aprada-tepui	aprada-tepui
northern_yatsugatake_volcanic_group	northern_yatsugatake_volcanic_group
antikuna	antikuna
whitetop_mountain	whitetop_mountain
mount_oizuru	mount_oizuru
plose	plose
rugged_mountain	rugged_mountain
lin_fa_shan	lin_fa_shan
fresno_dome	fresno_dome
monte_pastello	monte_pastello
piz_segnas	piz_segnas
urddalsknuten	urddalsknuten
keilhaus_topp	keilhaus_topp
nguruman_escarpment	nguruman_escarpment
piz_sena	piz_sena
chiqllarasu	chiqllarasu
survey_peak	survey_peak
tonale_pass	tonale_pass
yonah_mountain	yonah_mountain
beartooth_mountains	beartooth_mountains
rauher_berg	rauher_berg
win_hill	win_hill
kuh-e_hajji_koshteh	kuh-e_hajji_koshteh
dents_de_lanfon	dents_de_lanfon
cold_overton_park	cold_overton_park
artillery_knob	artillery_knob
lost_pass	lost_pass
awkillu	awkillu
concarena	concarena
czantoria_wielka	czantoria_wielka
young_lick	young_lick
mount_mcmaster	mount_mcmaster
syberg	syberg
middle_triple_peak	middle_triple_peak
plattkofel	plattkofel
tsambagarav	tsambagarav
tells_peak	tells_peak
velmerstot	velmerstot
langila	langila
carnedd_dafydd	carnedd_dafydd
sant_mamet	sant_mamet
larrun	larrun
bald_eagle_mountain	bald_eagle_mountain
kates_needle	kates_needle
maulin	maulin
piz_fora	piz_fora
lost_mountain	lost_mountain
mittagspitz	mittagspitz
mount_davis_(california)	mount_davis_(california)
rammelsberg	rammelsberg
mount_anne	mount_anne
mount_shirouma	mount_shirouma
pointe_de_paumont	pointe_de_paumont
sideling_hill	sideling_hill
absaroka_range	absaroka_range
suusamyr_too	suusamyr_too
monte_solarolo	monte_solarolo
bugwisan	bugwisan
sentinel_range	sentinel_range
eilumer_horn	eilumer_horn
mount_massif	mount_massif
naebyeonsan	naebyeonsan
sonntagshorn	sonntagshorn
telegraph_peak_(california)	telegraph_peak_(california)
cloghernagh	cloghernagh
cima_di_cugn	cima_di_cugn
jasper_peak	jasper_peak
kasprowy_wierch	kasprowy_wierch
salzburger_spitzl	salzburger_spitzl
ilkley_moor	ilkley_moor
schijenflue	schijenflue
mount_haystack	mount_haystack
white_peaks	white_peaks
punta_scais	punta_scais
douglas_knob	douglas_knob
mount_solomons	mount_solomons
slieve_carr	slieve_carr
rahu_qulluta	rahu_qulluta
stoney_indian_peaks	stoney_indian_peaks
jabal_hafarah	jabal_hafarah
jeoksangsan	jeoksangsan
pen_y_castell	pen_y_castell
blue_ridge_mountain	blue_ridge_mountain
glyder_fawr	glyder_fawr
kolokol_group	kolokol_group
ko_mountain	ko_mountain
mount_annaguan	mount_annaguan
south_suicide_peak	south_suicide_peak
godor	godor
cima_di_rosso	cima_di_rosso
ellsworth_mountains	ellsworth_mountains
legges_tor	legges_tor
mount_ibuki	mount_ibuki
fan_fawr	fan_fawr
mcgown_peak	mcgown_peak
nevado_del_plomo	nevado_del_plomo
agia_dynati	agia_dynati
ponmudi	ponmudi
mount_adams_(new_hampshire)	mount_adams_(new_hampshire)
roche_perfia	roche_perfia
mount_keith	mount_keith
billinge_hill	billinge_hill
cim_del_mont-roig	cim_del_mont-roig
cucamonga_peak	cucamonga_peak
rogers_peak	rogers_peak
yanawaqra	yanawaqra
river_knobs_(west_virginia)	river_knobs_(west_virginia)
bulbarrow_hill	bulbarrow_hill
tray_mountain	tray_mountain
bec_d'epicoune	bec_d'epicoune
zrinska_gora	zrinska_gora
massacre_peak	massacre_peak
the_devil's_nose	the_devil's_nose
aheloy_nunatak	aheloy_nunatak
wayrakancha	wayrakancha
gemsstock	gemsstock
serra_de_crevillent	serra_de_crevillent
diklosmta	diklosmta
ruby_dome	ruby_dome
els_munts	els_munts
rognstadkollen	rognstadkollen
mount_wister	mount_wister
catfish_mountain	catfish_mountain
gallatin_range	gallatin_range
om_parvat	om_parvat
sutton_peak	sutton_peak
parry_peak	parry_peak
gistola	gistola
druesberg	druesberg
terminio	terminio
camaderry	camaderry
pilone	pilone
sangthang	sangthang
kloppstert	kloppstert
mol_len	mol_len
nospitz	nospitz
besiberri_sud	besiberri_sud
thunderbird_mountain	thunderbird_mountain
new_creek_mountain	new_creek_mountain
mount_colvin	mount_colvin
short_hill_mountain	short_hill_mountain
haldalsnuten	haldalsnuten
allamuchy_mountain	allamuchy_mountain
grand_ballon	grand_ballon
chno_dearg	chno_dearg
skillern_peak	skillern_peak
mount_breitenbach	mount_breitenbach
hungry_hill	hungry_hill
monte_plische	monte_plische
black_mountain_south_top	black_mountain_south_top
mount_lurus	mount_lurus
forellen_peak	forellen_peak
novarupta	novarupta
gothics	gothics
saipal	saipal
guadalupe_mountains	guadalupe_mountains
jinaksan	jinaksan
niedere_tauern	niedere_tauern
terrace_mountain	terrace_mountain
pico_humboldt	pico_humboldt
suitilla	suitilla
blue_job_mountain	blue_job_mountain
higger_tor	higger_tor
annagh_hill	annagh_hill
poppy_mountain	poppy_mountain
mount_rogers	mount_rogers
lambs_knoll	lambs_knoll
la_tournette	la_tournette
crug_hywel	crug_hywel
great_orme	great_orme
emlembe	emlembe
monte_minisfreddo	monte_minisfreddo
sloan_peak	sloan_peak
mount_foraker	mount_foraker
monte_pian_falcone	monte_pian_falcone
roccia_nera	roccia_nera
llwytmor	llwytmor
mount_batu_brinchang	mount_batu_brinchang
tarrenhendre	tarrenhendre
middle_moriah_mountain	middle_moriah_mountain
tshibinda	tshibinda
cefn_yr_ogof	cefn_yr_ogof
granatspitze	granatspitze
jabal_yis	jabal_yis
crowfeet_mountain	crowfeet_mountain
raudebergnuten	raudebergnuten
angel's_perch	angel's_perch
jabal_ad_dayt	jabal_ad_dayt
ebony_peak	ebony_peak
cook_peak	cook_peak
hornelen	hornelen
middle_mountain	middle_mountain
calf_top	calf_top
monte_mutria	monte_mutria
swift_run_gap	swift_run_gap
pizzo_bellavista	pizzo_bellavista
packrat_peak	packrat_peak
veneziaspitze	veneziaspitze
mount_dodo	mount_dodo
mount_kitanglad	mount_kitanglad
amba_geshen	amba_geshen
piz_corbet	piz_corbet
aiguille_de_borderan	aiguille_de_borderan
jabal_bayqah	jabal_bayqah
mount_rockwell	mount_rockwell
musuan_peak	musuan_peak
indian_heaven	indian_heaven
cobb_mountain	cobb_mountain
ritacuba_blanco	ritacuba_blanco
corno_bianco	corno_bianco
cirque_lake_peak	cirque_lake_peak
tiger_mountain	tiger_mountain
eldon_hill	eldon_hill
monte_ferro	monte_ferro
mount_wachusett	mount_wachusett
boomerang_range	boomerang_range
belknap_mountain	belknap_mountain
bamba_dhura	bamba_dhura
salher	salher
monte_bondone	monte_bondone
mount_api	mount_api
lantau_peak	lantau_peak
pico_do_monte_negro	pico_do_monte_negro
paryaqaqa	paryaqaqa
fronalpstock	fronalpstock
mount_mantalingajan	mount_mantalingajan
aiguille_de_bionnassay	aiguille_de_bionnassay
prokletije	prokletije
tymfi	tymfi
foel_wen	foel_wen
mount_peale	mount_peale
little_diamond_peak	little_diamond_peak
cima_di_jazzi	cima_di_jazzi
aiguille_de_l'a_neuve	aiguille_de_l'a_neuve
mount_clay	mount_clay
wetterhorn_peak	wetterhorn_peak
beinn_chabhair	beinn_chabhair
messnerin	messnerin
piz_chavalatsch	piz_chavalatsch
dave's_peak	dave's_peak
jobs_peak	jobs_peak
santanoni_peak	santanoni_peak
eastern_breithorn	eastern_breithorn
puntal_dels_escambrons	puntal_dels_escambrons
pointe_d'areu	pointe_d'areu
snowyside_peak	snowyside_peak
lohagad	lohagad
mullaghcleevaun	mullaghcleevaun
pimple_hills	pimple_hills
watchung_mountains	watchung_mountains
mittagstock	mittagstock
jabal_gral	jabal_gral
dinaric_alps	dinaric_alps
bangjangsan	bangjangsan
nasaasaaq	nasaasaaq
bagana	bagana
gairich	gairich
cribin_fawr	cribin_fawr
hohsandhorn	hohsandhorn
hamlin_peak	hamlin_peak
haut_sex	haut_sex
roques_de_benet	roques_de_benet
glyder_fach	glyder_fach
haddington_hill	haddington_hill
mount_igikpak	mount_igikpak
dents_blanches	dents_blanches
turkestan_range	turkestan_range
mount_arith	mount_arith
sierra_de_la_alfaguara	sierra_de_la_alfaguara
mount_cammerer	mount_cammerer
abi_gamin	abi_gamin
julsennosi	julsennosi
leckihorn	leckihorn
nat_ma_taung	nat_ma_taung
monte_secco	monte_secco
brandsnutene	brandsnutene
lodner	lodner
kiso_mountains	kiso_mountains
methana_volcano	methana_volcano
tordoki_yani	tordoki_yani
magerrain	magerrain
box_springs_mountain	box_springs_mountain
jacks_mountain	jacks_mountain
manhaengsan	manhaengsan
lefka_ori	lefka_ori
frazier_mountain	frazier_mountain
albrunhorn	albrunhorn
monte_conero	monte_conero
usgs_peak	usgs_peak
mount_zealand	mount_zealand
kanisfluh	kanisfluh
fan_llia	fan_llia
cheeks_hill	cheeks_hill
rhonestock	rhonestock
caraiman_peak	caraiman_peak
amphitheater_mountain_(montana)	apikuni_mountain
amphitheater_mountain_(montana)	amphitheater_mountain_(montana)
gran_tuc_de_colomers	gran_tuc_de_colomers
kopet_dag	kopet_dag
red_lake_peak	red_lake_peak
manaslu	manaslu
bobotov_kuk	bobotov_kuk
poco_mandasawu	poco_mandasawu
monte_cabianca	monte_cabianca
younts_peak	younts_peak
wai_sano	wai_sano
mynydd_llysiau	mynydd_llysiau
genovesa_island	genovesa_island
braxon_peak	braxon_peak
chamor_hill	chamor_hill
elbe_sandstone_mountains	elbe_sandstone_mountains
mittlerspitz	mittlerspitz
mount_quincan	mount_quincan
anamudi	anamudi
mont_saint-hilaire	mont_saint-hilaire
pointe_des_brasses	pointe_des_brasses
bangmunsan	bangmunsan
mount_edred	mount_edred
puig_tomir	puig_tomir
monte_pruno	monte_pruno
great_needle_peak	great_needle_peak
kantili	kantili
monte_pian_nave	monte_pian_nave
hacha_grande	hacha_grande
malchin_peak	malchin_peak
grand_capucin	grand_capucin
hanging_rock,_victoria	hanging_rock,_victoria
barrier_volcano	barrier_volcano
mount_samat	mount_samat
jabal_ad_daya'	jabal_ad_daya'
presidential_range	presidential_range
mount_si	mount_si
mont_d'arbois	mont_d'arbois
sentraltind	sentraltind
gyala_peri	gyala_peri
monte_del_forno	monte_del_forno
little_cacapon_mountain	little_cacapon_mountain
punta_ramiere	punta_ramiere
big_savage_mountain	big_savage_mountain
mount_macolod	mount_macolod
korpehaugen	korpehaugen
storbreatinden	loftet
doi_inthanon	doi_inthanon
mauna_loa	mauna_loa
peters_dome	peters_dome
paganella	paganella
hochkelberg	hochkelberg
kabargin_oth_group	kabargin_oth_group
cima_palon	cima_palon
mount_epperly	mount_epperly
alto_de_nique	alto_de_nique
cuyapaipe_mountain	cuyapaipe_mountain
goode_mountain	goode_mountain
mont_fourchon	mont_fourchon
watnong_mountain	watnong_mountain
morro_da_boa_vista	morro_da_boa_vista
moelfre_uchaf	moelfre_uchaf
jaufenpass	jaufenpass
aberdare_range	aberdare_range
mount_raiden	mount_mekunnai
alcovy_mountain	alcovy_mountain
akaishi_mountains	akaishi_mountains
trupejevo_poldne	trupejevo_poldne
uksichan	uksichan
haycock_mountain	haycock_mountain
dilj	dilj
mount_dampier	mount_dampier
torreys_peak	torreys_peak
theodulhorn	theodulhorn
aiguille_croche	aiguille_croche
wei-assipu-tepui	wei-assipu-tepui
mogollon_baldy	mogollon_baldy
ganekogorta	ganekogorta
cim_de_pla_de_pujalts	cim_de_pla_de_pujalts
kolana_rock	kolana_rock
jabal_ghura	jabal_ghura
mount_neacola	mount_neacola
la_spedla	la_spedla
currahee_mountain	currahee_mountain
jabal_ad_dahir	jabal_ad_dahir
monti_li_foj	monti_li_foj
kusum_kanguru	kusum_kanguru
falakro	falakro
griffin_butte	griffin_butte
turner's_gap	turner's_gap
goffle_hill	goffle_hill
howlock_mountain	howlock_mountain
k2	k2
north_suicide_peak	north_suicide_peak
el_mela	el_mela
puig_de_la_talaia	puig_de_la_talaia
monte_paterno	monte_paterno
punta_valgrande	punta_valgrande
pizzo_badile_camuno	pizzo_badile_camuno
mont_buet	mont_buet
pendle_hill	pendle_hill
skrim	skrim
mount_manchester	mount_manchester
monte_zebio	monte_zebio
molamenqing	molamenqing
monte_pora	monte_pora
big_interior_mountain	big_interior_mountain
pizes_de_cir	pizes_de_cir
pico_da_bandeira	pico_da_bandeira
adam's_peak	adam's_peak
rabun_bald	rabun_bald
gafleispitz	gafleispitz
sharktooth_peak	sharktooth_peak
walton_mountains	walton_mountains
cerro_de_los_siete_colores	cerro_de_los_siete_colores
hoch_horefellistock	hoch_horefellistock
cervialto	cervialto
angilaaq_mountain	angilaaq_mountain
mount_sheridan	mount_sheridan
chugush	chugush
mount_abbot	mount_abbot
mount_heber	mount_heber
craiglwyn	craiglwyn
dreifaltigkeitsberg	daumberg
khao_ok_talu	khao_ok_talu
atkins_peak	atkins_peak
monte_catria	monte_catria
holtefjell	holtefjell
moelfre_isaf	moelfre_isaf
throop_peak	throop_peak
brunecker_turm	brunecker_turm
mount_fernow	mount_fernow
maturango_peak	maturango_peak
mount_mendel	mount_mendel
white_mountain_peak	white_mountain_peak
mount_whittier	mount_whittier
lima_mountain	lima_mountain
monte_tremalzo	monte_tremalzo
mount_kipp	mount_kipp
jach'aqullu	jach'aqullu
slemish	slemish
croagh_patrick	croagh_patrick
arrowhead_mountain	arrowhead_mountain
puig_de_fontlletera	puig_de_fontlletera
clariden	clariden
imingfjellet	imingfjellet
mount_bierstadt	mount_bierstadt
batorampon_point	batorampon_point
mount_marcy	mount_marcy
shah_alborz	shah_alborz
hayden_peak	hayden_peak
mount_sumagaya	mount_sumagaya
mount_robert	mount_robert
schilt	schilt
mount_boardman	mount_boardman
hautza	hautza
ponten_(mountain)	zabelstein
ponten_(mountain)	sattelkopf
piegan_mountain	piegan_mountain
mount_stuart	mount_stuart
potrillo_volcanic_field	potrillo_volcanic_field
jabal_darah	jabal_darah
piz_pombi	piz_pombi
mount_webster	mount_webster
rish_pass	rish_pass
sella_towers	sella_towers
monte_carmine	monte_carmine
salasungo	salasungo
terminal_peak	terminal_peak
kronplatz	kronplatz
lone_wolf_mountain	lone_wolf_mountain
monte_croce_di_muggio	monte_croce_di_muggio
cushetunk_mountain	cushetunk_mountain
gruppo_della_carega	gruppo_della_carega
mount_mutis	mount_mutis
dinara	dinara
jepson_peak	jepson_peak
monte_raione	monte_raione
namdeogyusan	namdeogyusan
mir_samir	mir_samir
cinque_torri	cinque_torri
bimberi_peak	bimberi_peak
deoksungsan	deoksungsan
boundary_peak_79	boundary_peak_79
middle_carter_mountain	middle_carter_mountain
tagewaldhorn	tagewaldhorn
hausdalshorga	hausdalshorga
tossa_de_viamar	tossa_de_viamar
belmore_mountain	belmore_mountain
kleinglockner	kleinglockner
mount_bellamy	mount_bellamy
tecuya_mountain	tecuya_mountain
villanderer_berg	villanderer_berg
monte_cardosa	monte_cardosa
palomar_mountain	palomar_mountain
mount_cupola	mount_cupola
oiz	oiz
col_di_lana	col_di_lana
higravstinden	higravstinden
benther_berg	benther_berg
mount_farquhar	mount_farquhar
rajrambha	rajrambha
amherst_peak	amherst_peak
kotel_pass	kotel_pass
mount_winchell	mount_winchell
mount_shinn	mount_shinn
mount_brewer	mount_brewer
mount_wilkinson	mount_wilkinson
pen_y_fan	pen_y_fan
redcloud_peak	redcloud_peak
rabaul_caldera	rabaul_caldera
piz_sardona	piz_sardona
alto_san_juan	alto_san_juan
mount_cramer	mount_cramer
jakobsspitze	jakobsspitze
pihanga	pihanga
balakun	balakun
prisojnik	prisojnik
piz_buin	piz_buin
mount_tyndall	mount_tyndall
bogda_peak	bogda_peak
monte_alpi	monte_alpi
mera_peak	mera_peak
maurerberg	maurerberg
parnon	parnon
kyes_peak	kyes_peak
mount_mackenzie	mount_mackenzie
monte_moro	monte_moro
preakness_range	preakness_range
pelion_range	pelion_range
grace_peak	grace_peak
ensign_peak	ensign_peak
manzanita_peak	manzanita_peak
labuche_kang	labuche_kang
waterman_mountain	waterman_mountain
khentii_mountains	khentii_mountains
mahoney_butte	mahoney_butte
risnjak	risnjak
franconia_range	franconia_range
mount_zuqualla	mount_zuqualla
liskampen	liskampen
sentinel_rock	sentinel_rock
mount_mcclintock	mount_mcclintock
oseosan	oseosan
tossal_de_mirapallars_i_urgell	tossal_de_mirapallars_i_urgell
gragareth	gragareth
milestone_mountain	milestone_mountain
kasatochi_island	kasatochi_island
hemsedalsfjella	hemsedalsfjella
mount_holmes	mount_holmes
jabal_mimduk	jabal_mimduk
piz_urlaun	piz_urlaun
mount_banahaw	mount_banahaw
mcfarland_peak	mcfarland_peak
mount_ariel	mount_ariel
pitchoff_mountain	pitchoff_mountain
george_peak	george_peak
king_davids_peak	king_davids_peak
milany	milany
mount_princeton	mount_princeton
mount_duckabush	mount_duckabush
makra_peak	makra_peak
mount_hornaday	mount_hornaday
mount_hiri	mount_hiri
witenalpstock	witenalpstock
organ_needle	organ_needle
wittenberg_mountain	wittenberg_mountain
poggio_sommorto	poggio_sommorto
bismarck_range	bismarck_range
milevska_planina	milevska_planina
mont_blanc	mont_blanc
pointe_kurz	pointe_kurz
torreneules	torreneules
mount_rubidoux	mount_rubidoux
brown_clee_hill	brown_clee_hill
gullsteinen	gullsteinen
mount_pinos	mount_pinos
bric_del_terma	bric_del_terma
sharp_haw	sharp_haw
curly_bear_mountain	curly_bear_mountain
maja_e_tomorrit	maja_e_tomorrit
mount_haynes	mount_haynes
arbuckle_mountains	arbuckle_mountains
ben_macdui	ben_macdui
hiunchuli	hiunchuli
mount_clarence_king	mount_clarence_king
mount_monroe	mount_monroe
gaor_bheinn	gaor_bheinn
goda_mountains	goda_mountains
parsons_peak	parsons_peak
yeonseoksan	yeonseoksan
piz_lavirun	piz_lavirun
maiella	maiella
huron_peak	huron_peak
bayle_mountain	bayle_mountain
the_red_pillar	the_red_pillar
espadas_peak	espadas_peak
mount_haddington	mount_haddington
holston_mountain	holston_mountain
great_knoutberry_hill	great_knoutberry_hill
south_crocker_mountain	south_crocker_mountain
monte_pegherolo	monte_pegherolo
todoko-ranu	todoko-ranu
black_mixen	black_mixen
redondo_peak	redondo_peak
sonnighorn	sonnighorn
foel_wen_south_top	foel_wen_south_top
store_memurutinden	store_memurutinden
skarvanfjellet	skarvanfjellet
maquilla_peak	maquilla_peak
ptari-tepui	ptari-tepui
mount_geryon	mount_geryon
mittlerer_sonnblick	mittlerer_sonnblick
baraebong	baraebong
fountains_fell	fountains_fell
monte_venerocolo	monte_venerocolo
saimaluu_tash	saimaluu_tash
piz_tea_fondada	piz_tea_fondada
baga_bogd	baga_bogd
koshtan-tau	koshtan-tau
jabal_fujayrah	jabal_fujayrah
wilder_pfaff	wilder_pfaff
sitaq	sitaq
argentine_peak	argentine_peak
monte_piana	monte_piana
paulet_island	paulet_island
pico_piedras_blancas	pico_piedras_blancas
piz_saliente	piz_saliente
mount_mallory	mount_mallory
thorpe_cloud	thorpe_cloud
bannock_peak	bannock_peak
dix_mountain	dix_mountain
kitzsteinhorn	kitzsteinhorn
bonden	bonden
otdelny	otdelny
vakak_group	vakak_group
wind_river_peak	wind_river_peak
creigiau_gleision_north_top	creigiau_gleision_north_top
fleckistock	fleckistock
hoher_angelus	hoher_angelus
kersal_moor	kersal_moor
serra_d'irta	serra_d'irta
lava_butte	lava_butte
fair_snape_fell	fair_snape_fell
middle_palisade	middle_palisade
surettahorn	surettahorn
kaweka_j	kaweka_j
reineskarvet	reineskarvet
aiguilles_de_la_penaz	aiguilles_de_la_penaz
cadair_berwyn	cadair_berwyn
mount_lumarku	mount_lumarku
queen_peak	queen_peak
waianae_range	waianae_range
cowrock_mountain	cowrock_mountain
mount_weaver	mount_weaver
goat_haunt_mountain	goat_haunt_mountain
ama_dablam	ama_dablam
elfenstein	elfenstein
dieng_volcanic_complex	dieng_volcanic_complex
monte_summano	monte_summano
pizzo_del_diavolo_della_malgina	pizzo_del_diavolo_della_malgina
jagged_mountain	jagged_mountain
skyang_kangri	skyang_kangri
mount_whiteface	mount_whiteface
aughenbaugh_peak	aughenbaugh_peak
los_patos	los_patos
fan_y_big	fan_y_big
eagles_rest_peak	eagles_rest_peak
aiguille_du_plan	aiguille_du_plan
puzzle_mountain	puzzle_mountain
creta_forata	creta_forata
kitt_peak	kitt_peak
red_hill_volcanic_field	red_hill_volcanic_field
sarntal_alps	sarntal_alps
eagle's_nest_hill	eagle's_nest_hill
parrossaz	parrossaz
ashnola_mountain	ashnola_mountain
mount_sill	mount_sill
marysvale_volcanic_field	marysvale_volcanic_field
gross_furkahorn	gross_furkahorn
a'_mhaighdean	a'_mhaighdean
big_pine_mountain	big_pine_mountain
monte_sissone	monte_sissone
whiskey_dick_mountain	whiskey_dick_mountain
independence_peak	independence_peak
nemjung	nemjung
mount_humphreys	mount_humphreys
hochgolling	hochgolling
horton_peak	horton_peak
mount_meeker	mount_meeker
mount_kasa	mount_kasa
banua_wuhu	banua_wuhu
corna_mara	corna_mara
tifata	tifata
veliki_kozjak	veliki_kozjak
pizzocco	pizzocco
pizzo_rotondo_(orobie)	pizzo_rotondo_(orobie)
pic_de_la_dona	pic_de_la_dona
mount_thielsen	mount_thielsen
craigysgafn	craigysgafn
mount_kyllini	mount_kyllini
roc_del_comptador	roc_del_comptador
kolbenspitze	kolbenspitze
salinas_peak	salinas_peak
lifjell_(kongsberg)	lifjell_(kongsberg)
crompton_moor	crompton_moor
mont_chapman	mont_chapman
backdrop_peak	backdrop_peak
east_peak_mount_osceola	east_peak_mount_osceola
red_slate_mountain	red_slate_mountain
miljonuten	miljonuten
punta_senyalada	punta_senyalada
tymfristos	tymfristos
hjelledalstind	hjelledalstind
mount_derby	mount_derby
binnein_beag	binnein_beag
vetta_di_ron	vetta_di_ron
puig_de_randa	puig_de_randa
rouen_mountains	rouen_mountains
monte_cristo_peak	monte_cristo_peak
lyaskovets_peak	lyaskovets_peak
julian_alps	julian_alps
twin_sisters_mountain	twin_sisters_mountain
the_behinde	the_behinde
lygkos	lygkos
mount_sunapee	mount_sunapee
mount_shani	mount_shani
windham_high_peak	windham_high_peak
mount_pulong_bato	mount_pulong_bato
altair_peak	altair_peak
medicine_owl_peak	medicine_owl_peak
loi_pangnao	loi_pangnao
mount_tyree	mount_tyree
roca_colom	roca_colom
hochfeiler	hochfeiler
vesper_peak	vesper_peak
bergeheii	bergeheii
kohnstein	kohnstein
thimble_peak	thimble_peak
storjuvtinden	storjuvtinden
lochnagar	lochnagar
west_spanish_peak	west_spanish_peak
uritorco	uritorco
vetta_del_vallone	vetta_del_vallone
uri-rotstock	uri-rotstock
suretta	suretta
dorje_lhakpa	dorje_lhakpa
mullacor	mullacor
stetind	stetind
monte_elto	monte_elto
rhos_dirion	rhos_dirion
motto_della_tappa	motto_della_tappa
north_carter_mountain	north_carter_mountain
the_calf	the_calf
nevado_el_cisne	nevado_el_cisne
piz_canfinal	piz_canfinal
grosser_mythen	grosser_mythen
mount_marsabit	mount_marsabit
kuh-e_bandaka	kuh-e_bandaka
ombigaichan	ombigaichan
mount_natazhat	mount_natazhat
monte_strega	monte_strega
gra_de_fajol_petit	gra_de_fajol_petit
hallett_peak	hallett_peak
mount_sutro	mount_sutro
llunk'uti	llunk'uti
monte_delle_figne	monte_delle_figne
veslebotnskarvet	veslebotnskarvet
helwangspitz	helwangspitz
besiberri_nord	besiberri_nord
monte_matto	monte_matto
hinterer_bratschenkopf	hinterer_bratschenkopf
mount_patah	mount_patah
gailtaler_polinik	gailtaler_polinik
viejas_mountain	viejas_mountain
medicine_grizzly_peak	medicine_grizzly_peak
cuyamaca_peak	cuyamaca_peak
kleiner_rummelsberg	kleiner_rummelsberg
veiled_peak	veiled_peak
shrewsbury_peak	shrewsbury_peak
jabal_shariyah	jabal_shariyah
taconic_mountains	taconic_mountains
marjan	marjan
petit_grepon	petit_grepon
kintla_peak	kintla_peak
mount_talinis	mount_talinis
mount_kelly	mount_kelly
moncong_lompobatang	moncong_lompobatang
monte_ferrante	monte_ferrante
snegovoy	snegovoy
monte_vesta	monte_vesta
monte_cecilia	monte_cecilia
mount_herschel	mount_herschel
mount_rutford	mount_rutford
billingen	billingen
sierra_de_javalambre	sierra_de_javalambre
slieve_croob	slieve_croob
lancebranlette	lancebranlette
chin_hills	chin_hills
mount_tagapo	mount_tagapo
mount_shaw	mount_shaw
dick's_knob	dick's_knob
mount_polis	mount_polis
mount_silberhorn	mount_silberhorn
mount_davraz	mount_davraz
mount_isto	mount_isto
punta_del_pollo	punta_del_pollo
tibidabo	tibidabo
monte_triomen	monte_triomen
tai_mun_shan	tai_mun_shan
kaina_mountain	kaina_mountain
aiguille_du_tour	aiguille_du_tour
monte_carpegna	monte_carpegna
medvezhya	medvezhya
skarvsenden	skarvsenden
moravian-silesian_beskids	moravian-silesian_beskids
kennesaw_mountain	kennesaw_mountain
scharfenstein_(hesse)	wartberg_(niedenstein)
scharfenstein_(hesse)	scharfenstein_(hesse)
mount_grinnell	mount_grinnell
shaker_mountain	shaker_mountain
el_totumo	el_totumo
mont-aux-sources	mont-aux-sources
mam_tor	mam_tor
burphu_dhura	burphu_dhura
lolah-ye_gaw_kush	lolah-ye_gaw_kush
mount_lloyd_jones	mount_lloyd_jones
mount_democrat	mount_democrat
mount_sizer	mount_sizer
skarstind	skarstind
bivouac_peak	bivouac_peak
mount_dickey	mount_dickey
monte_perdido	monte_perdido
cholatse	cholatse
owens_peak	owens_peak
turbacz	turbacz
beagle_peak	beagle_peak
ranastongi	ranastongi
urbasa	urbasa
sunset_crater	sunset_crater
humpy_peak	humpy_peak
eggstock	eggstock
mount_sorell	mount_sorell
lone_pine_peak	lone_pine_peak
tiefenstock	tiefenstock
pen_allt-mawr	pen_allt-mawr
hillary_peak	hillary_peak
latelhorn	latelhorn
schneestock	schneestock
noonmark_mountain	noonmark_mountain
no_regret_peak	no_regret_peak
monte_bicco	monte_bicco
vladimir_putin_peak	vladimir_putin_peak
woss_mountain	woss_mountain
aschentalshalbe	aschentalshalbe
dorset_mountain	dorset_mountain
kongde_ri	kongde_ri
bashful_peak	bashful_peak
skottinden	skottinden
garnedd_goch	garnedd_goch
eagle_rest_peak	eagle_rest_peak
monte_canto	monte_canto
jabal_murayshid	jabal_murayshid
ougarta_range	ougarta_range
charlotte_dome	charlotte_dome
westmount_summit	westmount_summit
haast_pass	haast_pass
grand_golliat	grand_golliat
mount_steamer	mount_steamer
mount_greylock	mount_greylock
wasatch_range	wasatch_range
tolmachev_dol	tolmachev_dol
manaraga	manaraga
mangere_mountain	mangere_mountain
amba_aradam	amba_aradam
south_dix	south_dix
y_gyrn	y_gyrn
jabal_sharmah	jabal_sharmah
store_hellstugutinden	store_hellstugutinden
mount_strahan	mount_strahan
mount_tire'm	mount_tire'm
cockedhat_mountain	cockedhat_mountain
aratz	aratz
brassiere_hills	brassiere_hills
mount_foster	mount_foster
mount_tasman	mount_tasman
kang_guru	kang_guru
mount_thetis	mount_thetis
gran_encantat	gran_encantat
puig_drau	puig_drau
ali_olo	ali_olo
schwarzberghorn	schwarzberghorn
lalla_khedidja	lalla_khedidja
quamby_bluff	quamby_bluff
ikh_bogd	ikh_bogd
auke_mountain	auke_mountain
herefordshire_beacon	herefordshire_beacon
braakberg	braakberg
oligyrtos	oligyrtos
creise	creise
marifjell	marifjell
bangor_mountain	bangor_mountain
kibby_mountain	kibby_mountain
wayna_qutuni	wayna_qutuni
vrontous	vrontous
three_rivers_peak	three_rivers_peak
pico_da_vara	pico_da_vara
mutnovsky	mutnovsky
golica	golica
schildspitze	schildspitze
monte_meidassa	monte_meidassa
monte_taccone	monte_taccone
pizzo_del_becco	pizzo_del_becco
mount_binaiya	mount_binaiya
antarasu	antarasu
mount_kelam	mount_kelam
tossal_de_les_torretes	tossal_de_les_torretes
gorbea	gorbea
monte_boglia	monte_boglia
steinheii	steinheii
witwatersrand	witwatersrand
voio	voio
mallos_de_riglos	mallos_de_riglos
keadeen	keadeen
gaularfjellet	gaularfjellet
devilsmother	devilsmother
sandersons_hope	sandersons_hope
rumija	rumija
toro_peak	toro_peak
museongsan	museongsan
mount_pirongia	mount_pirongia
monti_della_meta	monti_della_meta
jabal_dadnah	jabal_dadnah
peaks_of_otter	peaks_of_otter
riang_kotang	riang_kotang
window_peak	window_peak
mount_no_more	mount_no_more
carn_menyn	carn_menyn
lunq'u	lunq'u
mugarra	mugarra
maidenform_peak	maidenform_peak
mount_kisokoma	mount_kisokoma
lyderhorn	lyderhorn
phu_kradueng	phu_kradueng
pic_de_contraix	pic_de_contraix
ushba	ushba
east_spanish_peak	east_spanish_peak
black_crater	black_crater
mount_merritt	mount_merritt
mount_merritt	ipasha_peak
la_plata_peak	la_plata_peak
baurtregaum	baurtregaum
mount_sherrill	mount_sherrill
pizzo_farno	pizzo_farno
tahquitz_peak	tahquitz_peak
hochwilde	hochwilde
slievenamon	slievenamon
sepulcher_mountain	sepulcher_mountain
gyachung_kang	gyachung_kang
shelf_bank	shelf_bank
clark_mountain_(california)	clark_mountain_(california)
mount_bond	mount_bond
vesle_jukleggi	vesle_jukleggi
cloudveil_dome	cloudveil_dome
mount_lantoy	mount_lantoy
taal_volcano	taal_volcano
cerro_tristeza	cerro_tristeza
monte_misma	monte_misma
mount_langford	mount_langford
castell_y_gwynt	castell_y_gwynt
binevenagh	binevenagh
dog_mountain	dog_mountain
jizera_mountains	jizera_mountains
marys_peak	marys_peak
monte_chiappo	monte_chiappo
parys_mountain	parys_mountain
laaser_spitze	laaser_spitze
mount_lister	mount_lister
kastelhorn	kastelhorn
mount_osborn	mount_osborn
monte_baldo	monte_baldo
alport_height	alport_height
mount_egbert	mount_egbert
north_berwick_law	north_berwick_law
colter_peak	colter_peak
wizard_island	wizard_island
kastelberg	kastelberg
lunkho_e_dosare	lunkho_e_dosare
south_brother	south_brother
mount_bannon	mount_bannon
handies_peak	handies_peak
pohatcong_mountain	pohatcong_mountain
jabal_al_balush	jabal_al_balush
sunshine_peak	sunshine_peak
esther_mountain	esther_mountain
monte_caplone	monte_caplone
korigad	korigad
torre_egger	torre_egger
hail_storm_hill	hail_storm_hill
kuhgrat	kuhgrat
mount_craddock	mount_craddock
skorpa_i_hol	skorpa_i_hol
montcau	montcau
rosni_peak	rosni_peak
hod_hill	hod_hill
telethrio	telethrio
maoile_lunndaidh	maoile_lunndaidh
pic_de_peguera	pic_de_peguera
county_house_mountain	county_house_mountain
boura_mountains	boura_mountains
psunj	psunj
hohe_acht	hohe_acht
mont_brouillard	mont_brouillard
dome_a	dome_a
rishi_pahar	rishi_pahar
nokhu_crags	nokhu_crags
liberty_peak	liberty_peak
monte_porche	monte_porche
nanda_pal	nanda_pal
old_rag_mountain	old_rag_mountain
breithorn	breithorn
mount_ascutney	mount_ascutney
puigsou	puigsou
monte_tonale	monte_tonale
farallones_de_cali	farallones_de_cali
mount_doane	mount_doane
azad_kuh	azad_kuh
sextener_rotwand	sextener_rotwand
sant_jeroni_(el_bruc)	sant_jeroni_(el_bruc)
comabona	comabona
beklemeto_pass	beklemeto_pass
mount_verstovia	mount_verstovia
mundeokbong	mundeokbong
the_moose's_tooth	the_moose's_tooth
uinta_mountains	uinta_mountains
mont_charvet	mont_charvet
imp_mountain	imp_mountain
anik_mountain	anik_mountain
the_bulge	the_bulge
mount_khalatsa	mount_khalatsa
brenibba	brenibba
hauts-forts	hauts-forts
mount_arrowsmith	mount_arrowsmith
khao_kho	khao_kho
benbradagh	benbradagh
squak_mountain	squak_mountain
baring_mountain	baring_mountain
mount_irving	mount_irving
plankenstein_(mountain)	rechelkopf
aguja_saint_exupery	aguja_saint_exupery
sawtooth_peak	sawtooth_peak
la_miranda	la_miranda
admiralty_mountains	admiralty_mountains
foel_fenlli	foel_fenlli
monte_solaro	monte_solaro
red_peak	red_peak
jabal_thawban	jabal_thawban
grivola	grivola
slieve_gallion	slieve_gallion
ameringkogel	ameringkogel
pico_alto	pico_alto
teewinot_mountain	teewinot_mountain
redtop_peak	redtop_peak
annex_peak	annex_peak
palo_pinto_mountains	palo_pinto_mountains
mount_jerai	mount_jerai
cerro_de_arcos	cerro_de_arcos
montejurra	montejurra
point_2210	point_2210
fan_frynych	fan_frynych
vargebreen	vargebreen
mount_jim_crow	mount_jim_crow
ristfeuchthorn	totenstein
ristfeuchthorn	rockelmann
ristfeuchthorn	wagendrischelhorn
pizzo_redorta	pizzo_redorta
sass_rigais	sass_rigais
mount_odin	mount_odin
stolsbergi	stolsbergi
hinterer_seelenkogel	hinterer_seelenkogel
mount_jedediah_smith	mount_jedediah_smith
corno_grande	corno_grande
l'agullola	l'agullola
barronette_peak	barronette_peak
fan_hir	fan_hir
post_gwyn	post_gwyn
frenchman_mountain	frenchman_mountain
moosberg	moosberg
leatherman_peak	leatherman_peak
maintop_mountain	maintop_mountain
wahcheechee_mountain	wahcheechee_mountain
voras_mountains	voras_mountains
piz_di_pian	piz_di_pian
pizzo_quadro	pizzo_quadro
ouray_peak	ouray_peak
vihren	vihren
sarcee_mountain	sarcee_mountain
mount_ethelred	mount_ethelred
zeballos_peak	zeballos_peak
nickerson_mountain	nickerson_mountain
kelimutu	kelimutu
ontario_peak	ontario_peak
mount_geikie	mount_geikie
mount_warren	mount_warren
mount_rosseau	mount_rosseau
umboi_island	umboi_island
monte_lozzo	monte_lozzo
mount_cain	mount_cain
southern_limestone_alps	southern_limestone_alps
wright_peak	wright_peak
central_breithorn	central_breithorn
torre_de_cerredo	torre_de_cerredo
barnacken	barnacken
mont_mallet	mont_mallet
drei_schwestern	drei_schwestern
fenneregg	fenneregg
diky_greben	diky_greben
grande_fourche	grande_fourche
ortstock	ortstock
brasstown_bald	brasstown_bald
moel_gyw	moel_gyw
federation_peak	federation_peak
store_styggedalstinden	store_styggedalstinden
piz_da_las_trais_linguas	piz_da_las_trais_linguas
mount_akanagi	mount_akanagi
andersnatten	andersnatten
lost_corner_mountain	lost_corner_mountain
monte_bove_sud	monte_bove_sud
suilven	suilven
wurmaulspitze	wurmaulspitze
wolds_top	wolds_top
helatoba-tarutung	helatoba-tarutung
tobaru	tobaru
paternkofel	paternkofel
monte_maddalena	monte_maddalena
gleouraich	gleouraich
rounds_mountain	rounds_mountain
matchlee_mountain	matchlee_mountain
pizzoc	pizzoc
crotched_mountain	crotched_mountain
pagasarri	pagasarri
sandwich_mountain	sandwich_mountain
mount_harwood	mount_harwood
mount_lukens	mount_lukens
monte_trobio	monte_trobio
piz_starlex	piz_starlex
pine_log_mountain	pine_log_mountain
factory_hill	factory_hill
doll_mountain	doll_mountain
uia_di_ciamarella	uia_di_ciamarella
mount_amundsen	mount_amundsen
naomi_peak	naomi_peak
the_guardhouse	the_guardhouse
num_ri	num_ri
mount_yale	mount_yale
cadair_bronwen	cadair_bronwen
symmetry_spire	symmetry_spire
khar_kush	khar_kush
thomas_peak	thomas_peak
elk_pond_mountain	elk_pond_mountain
silvrettahorn	silvrettahorn
danville_mountain	danville_mountain
mullach_nan_coirean	mullach_nan_coirean
wawayanda_mountain	wawayanda_mountain
lower_titus_peak	lower_titus_peak
steile_wand	steile_wand
arta_mountains	arta_mountains
aitz_txiki	aitz_txiki
kinnekulle	kinnekulle
monte_grabiasca	monte_grabiasca
mount_sarkali	mount_sarkali
picco_luigi_amedeo	picco_luigi_amedeo
mount_okmok	mount_okmok
may-ya-moto	may-ya-moto
noyna_hill	noyna_hill
mount_bosavi	mount_bosavi
mount_henkel	mount_henkel
pizzo_stella	pizzo_stella
pic_de_subenuix	pic_de_subenuix
mount_trusmadi	mount_trusmadi
nei_lak_shan	nei_lak_shan
mount_ritter	mount_ritter
wiki_peak	wiki_peak
tussey_mountain	tussey_mountain
san_gorgonio_mountain	san_gorgonio_mountain
mount_holt	mount_holt
kahlersberg	kahlersberg
fossebreen	fossebreen
piz_de_cressim	piz_de_cressim
wanq'uni	wanq'uni
frenchmans_cap	frenchmans_cap
monte_nuovo	monte_nuovo
tanasee_bald	tanasee_bald
sharp_peak	sharp_peak
mount_trafalgar	mount_trafalgar
yr_elen	yr_elen
mount_washburn	mount_washburn
nagalaphu	nagalaphu
piz_la_stretta	piz_la_stretta
webb_hill	webb_hill
mcclellan_butte	mcclellan_butte
pfingstberg_(potsdam)	pfingstberg_(potsdam)
stelvio_pass	stelvio_pass
south_weeks	south_weeks
moel_hebog	moel_hebog
brocky_peak	brocky_peak
dongsan	dongsan
jabal_buta	jabal_buta
furggen	furggen
styggmann	styggmann
paris_mountain	paris_mountain
piz_paradisin	piz_paradisin
little_kennesaw_mountain	little_kennesaw_mountain
doyle_peak	doyle_peak
gyeonggaksan	gyeonggaksan
iliwerung	iliwerung
monte_ceresino	monte_ceresino
mount_troy	mount_troy
pegwn_mawr	pegwn_mawr
mount_homa	mount_homa
scima_da_saoseo	scima_da_saoseo
big_moose_mountain	big_moose_mountain
mount_sikaram	mount_sikaram
piz_giuv	piz_giuv
puig_campana	puig_campana
saddleback_junior	saddleback_junior
roca_entravessada	roca_entravessada
old_speck_mountain	old_speck_mountain
slieve_donard	slieve_donard
tossal_d'orenga	tossal_d'orenga
shoshone_john_peak	shoshone_john_peak
san_andres_mountains	san_andres_mountains
ahklun_mountains	ahklun_mountains
mazorakopf	mazorakopf
bulgheria	bulgheria
hinter_tierberg	hinter_tierberg
monte_linzone	monte_linzone
ben_venue	ben_venue
smoky_dome	smoky_dome
cima_dodici	cima_dodici
tatra_mountains	tatra_mountains
mela_taung	mela_taung
monte_ferone	monte_ferone
maggies_peak	maggies_peak
pico_la_concha	pico_la_concha
mesa_de_los_tres_reyes	mesa_de_los_tres_reyes
marchhorn	marchhorn
dacht-i-navar_group	dacht-i-navar_group
greater_caucasus	greater_caucasus
jabal_wamm	jabal_wamm
mount_parang	mount_parang
myinmoletkat_taung	myinmoletkat_taung
benbaun	benbaun
gufelstock	gufelstock
portal_mountain	portal_mountain
mount_cardigan	mount_cardigan
jabal_ar_rumaylah	jabal_ar_rumaylah
kirchlispitzen	kirchlispitzen
mount_hijiri	mount_hijiri
highpointer_peak	highpointer_peak
breithornzwillinge	breithornzwillinge
mount_nancy	mount_nancy
phu_xai_lai_leng	phu_xai_lai_leng
divis	divis
cap_del_verd	cap_del_verd
gross_litzner	gross_litzner
kaldefjellet	kaldefjellet
similaun	similaun
dial_mountain	dial_mountain
crazy_mountains	crazy_mountains
seven_fingered_jack	seven_fingered_jack
slievemore	slievemore
mount_kaweah	mount_kaweah
mount_george_v	mount_george_v
pico_almanzor	pico_almanzor
coccovello	coccovello
puig_de_fontnegra	puig_de_fontnegra
north_fork_mountain	north_fork_mountain
rajgad	rajgad
mount_anglem	mount_anglem
telescope_peak	telescope_peak
gobulsan	gobulsan
karlesspitze	karlesspitze
mount_beaufort	mount_beaufort
mount_daniel	mount_daniel
mont_forel	mont_forel
wilde_kreuzspitze	wilde_kreuzspitze
gullfjellet	gullfjellet
eichelnkopf	eichelnkopf
wilsons_peak	wilsons_peak
mount_goddard	mount_goddard
vegglifjell	vegglifjell
lyshornet	lyshornet
monte_buio	monte_buio
big_hatchet_peak	big_hatchet_peak
antelao	antelao
mount_kurai	mount_kurai
thrypti	thrypti
mount_multnomah	mount_multnomah
willis_mountain	willis_mountain
mont_saint-bruno	mont_saint-bruno
strawberry_peak	strawberry_peak
fan_bwlch_chwyth	fan_bwlch_chwyth
hoove	hoove
stob_coire_easain	stob_coire_easain
klusenberg	klusenberg
pen-y-ghent	pen-y-ghent
sveigen	sveigen
obzor_pass	obzor_pass
schneealpe	schneealpe
ismoil_somoni_peak	ismoil_somoni_peak
golden_cap	golden_cap
barmer_spitze	barmer_spitze
amba_alagi	amba_alagi
cima_di_fojorina	cima_di_fojorina
cleft_peak	cleft_peak
papuk	papuk
north_col	north_col
naranjo_de_bulnes	naranjo_de_bulnes
galbraith_mountain	galbraith_mountain
cornone_di_blumone	cornone_di_blumone
mount_bear	mount_bear
mount_crescent	mount_crescent
swargarohini	swargarohini
cima_di_castello	cima_di_castello
bishops_cap	bishops_cap
trolltunga	trolltunga
pizzo_zerna	pizzo_zerna
santa_margarida_volcano	santa_margarida_volcano
vincent_pyramid	vincent_pyramid
besiberri_del_mig	besiberri_del_mig
besiberri_massif	besiberri_massif
kiirunavaara	kiirunavaara
pindus	pindus
harlyberg	harlyberg
piz_terza	piz_terza
glastenbury_mountain	glastenbury_mountain
canto_alto	canto_alto
aiguille_des_grands_charmoz	aiguille_des_grands_charmoz
knockboy	knockboy
jabal_mulfirah	jabal_mulfirah
kleiner_ravensberg	kleiner_ravensberg
mount_laing	mount_laing
redonda_mesa	redonda_mesa
titila	titila
kootenai_peak	kootenai_peak
gamchen	gamchen
mansusan	mansusan
majadita	majadita
agglsspitze	agglsspitze
coyote_mountain_(california)	coyote_mountain_(california)
uja_tirche	uja_tirche
tuc_del_caubo	tuc_del_caubo
julsennuten	julsennuten
monte_stino	monte_stino
endkopf	endkopf
sawnee_mountain	sawnee_mountain
taurus_mountains	taurus_mountains
mount_meek	mount_meek
sandia_mountains	sandia_mountains
puig_de_massanella	puig_de_massanella
tetnuldi	tetnuldi
cerro_marahuaca	cerro_marahuaca
nauderer_hennesiglspitze	nauderer_hennesiglspitze
punta_marguareis	punta_marguareis
torre_del_gran_san_pietro	torre_del_gran_san_pietro
phu_soi_dao	phu_soi_dao
mammoth_mountain	mammoth_mountain
massaemett_mountain	massaemett_mountain
jebel_musa_(morocco)	jebel_musa_(morocco)
vignemale	vignemale
yellowstone_caldera	yellowstone_caldera
bardon_peak	bardon_peak
khao_rom	khao_rom
white_crown_mountain	white_crown_mountain
peekamoose_mountain	peekamoose_mountain
jabal_ruham	jabal_ruham
lihesten	lihesten
hydalsberget	hydalsberget
puig_cornador_(vilanova_de_sau)	puig_cornador_(vilanova_de_sau)
hardeol	hardeol
bumhpa_bum	bumhpa_bum
al_khurays	al_khurays
pen_twyn_glas	pen_twyn_glas
ushkovsky	ushkovsky
biokovo	biokovo
gokyo_ri	gokyo_ri
foel_fraith	foel_fraith
latemar	latemar
hagatjennhaugen	hagatjennhaugen
captains_mountain	captains_mountain
puketutu_island	puketutu_island
puig_sesarques	puig_sesarques
ozernoy	ozernoy
wild_bank	wild_bank
shipka_pass	shipka_pass
wilson_gap	wilson_gap
gross_spannort	gross_spannort
spravedlnost	spravedlnost
kahler_asten	kahler_asten
mount_osceola	mount_osceola
venado_peak	venado_peak
karl_marx_peak	karl_marx_peak
monte_cornetto	monte_cornetto
mount_norris	mount_norris
stob_a'_choire_mheadhoin	stob_a'_choire_mheadhoin
hagelberg	hagelberg
hakgala_mountain	hakgala_mountain
brunnistock	brunnistock
mount_flume	mount_flume
mount_jurupa	mount_jurupa
monte_priora	monte_priora
blokktinden	blokktinden
hernio	hernio
mount_leuser	mount_leuser
shaneh-kuh	shaneh-kuh
haughmond_hill	haughmond_hill
bellot_mountain	bellot_mountain
pizzo_strinato	pizzo_strinato
mian-seh-chal	mian-seh-chal
fort_lewis_mountain	fort_lewis_mountain
valvelspitze	valvelspitze
black_pine_cone	black_pine_cone
dans_mountain	dans_mountain
sahale_mountain	sahale_mountain
rolling_thunder_mountain	rolling_thunder_mountain
ellingwood_point	ellingwood_point
o'leary_peak	o'leary_peak
zapaleri	zapaleri
patkhor_peak	patkhor_peak
runddelen	runddelen
mount_soledad	mount_soledad
mount_prindle	mount_prindle
shishapangma	shishapangma
skotjernhaugen	skotjernhaugen
cowles_mountain	cowles_mountain
olkaria	olkaria
bogoslof_island	bogoslof_island
furchetta	furchetta
kamakou	kamakou
beinn_udlamain	beinn_udlamain
hasselkopf	hasselkopf
mount_aibetsu	mount_aibetsu
gughe	gughe
zemu_gap_peak	zemu_gap_peak
mount_bartle_frere	mount_bartle_frere
pointe_lachenal	pointe_lachenal
schneck_(mountain)	kleiner_daumen
schneck_(mountain)	jochspitze
schneck_(mountain)	kleiner_wilder
schneck_(mountain)	laufbacher_eck
urraca_mesa	urraca_mesa
col_des_aravis	col_des_aravis
manghen_pass	manghen_pass
freel_peak	freel_peak
falso_azufre	falso_azufre
west_kennebago_mountain	west_kennebago_mountain
st._cyril_peak	st._cyril_peak
morrone	morrone
shebshi_mountains	shebshi_mountains
comanche_point	comanche_point
mount_james	mount_james
nephin	nephin
monte_grona	monte_grona
simi_peak	simi_peak
potosi_mountain	potosi_mountain
wandfluhhorn	wandfluhhorn
reineberg	reineberg
bromaghin_peak	bromaghin_peak
monte_zucco	monte_zucco
pointe_helbronner	pointe_helbronner
adlersberg	adlersberg
monte_iulio	monte_iulio
thorpe_fell_top	thorpe_fell_top
mount_kapalatmada	mount_kapalatmada
dzhangi-tau	dzhangi-tau
mount_silverheels	mount_silverheels
punta_baretti	punta_baretti
bolshoy_kekuknaysky	bolshoy_kekuknaysky
drosgl	drosgl
mont_dolent	mont_dolent
little_dog_mountain	little_dog_mountain
tucumcari_mountain	tucumcari_mountain
ports_de_tortosa-beseit	ports_de_tortosa-beseit
patterson_creek_mountain	patterson_creek_mountain
lembert_dome	lembert_dome
jebel_zem-zem	jebel_zem-zem
monte_aga	monte_secco
monte_aga	monte_aga
chatkal_range	chatkal_range
waun_rydd	waun_rydd
zavaritski_caldera	zavaritski_caldera
mount_tongariro	mount_tongariro
panum_crater	panum_crater
borkoldoy_too	borkoldoy_too
cima_della_bondasca	cima_della_bondasca
salbitschijen	salbitschijen
rakytov	rakytov
aiguille_noire_de_peuterey	aiguille_noire_de_peuterey
gropenbornskopf	gropenbornskopf
ben_klibreck	ben_klibreck
mount_lykaion	mount_lykaion
sonklarspitze	sonklarspitze
parlick	parlick
cho_oyu	cho_oyu
froze-to-death_mountain	froze-to-death_mountain
hominy_hills	hominy_hills
palanzone	palanzone
maumtrasna	maumtrasna
mount_mansfield	mount_mansfield
ratangad	ratangad
bruchberg	bruchberg
cimon_del_froppa	cimon_del_froppa
mount_batur	mount_batur
misquah_hills_high_point	misquah_hills_high_point
lucero_volcanic_field	lucero_volcanic_field
greys_peak	greys_peak
monte_verena	monte_verena
witenwasserenstock	witenwasserenstock
chlomo	chlomo
mont_bichet	mont_bichet
pen_y_gadair_fawr	pen_y_gadair_fawr
specimen_ridge	specimen_ridge
an_riabhachan	an_riabhachan
piz_timun	piz_timun
pic_de_l'aurore	pic_de_l'aurore
liushi_shan	liushi_shan
red_eagle_mountain	red_eagle_mountain
pass_of_the_republic	pass_of_the_republic
nibbi	nibbi
siah-kaman	siah-kaman
guadalupe_peak	guadalupe_peak
piz_di_sassiglion	piz_di_sassiglion
buaren	buaren
carrao-tepui	carrao-tepui
mount_mazama	mount_mazama
moel_yr_ewig	moel_yr_ewig
sandy_bay_mountain	sandy_bay_mountain
cerro_el_muerto	cerro_el_muerto
mount_naeba	mount_naeba
ore_mountains	ore_mountains
mount_cokely	mount_cokely
makrynoros	makrynoros
kaweah_queen	kaweah_queen
belasica	belasica
pizzo_straciugo	pizzo_straciugo
rwenzori_mountains	rwenzori_mountains
ingakslugwat_hills	ingakslugwat_hills
wamanrasu	wamanrasu
quadrant_mountain	quadrant_mountain
kamet	kamet
mount_susitna	mount_susitna
elkhorn_mountain	elkhorn_mountain
decker_peak	decker_peak
chimney_tops	chimney_tops
monte_gleno	monte_gleno
montes_universales	montes_universales
hochalt	hochalt
mount_kinpu	mount_kinpu
kangtega	kangtega
east_kennebago_mountain	east_kennebago_mountain
monte_prata	monte_prata
mount_baldr	mount_baldr
enciastraia	enciastraia
keyes_gap	keyes_gap
yanakusma	yanakusma
ward's_stone	ward's_stone
khazret_sultan	khazret_sultan
ben_nevis	ben_nevis
worcestershire_beacon	worcestershire_beacon
hoverberget	hoverberget
mount_moosilauke	mount_moosilauke
sparta_mountains	sparta_mountains
wentwood	wentwood
corni_di_canzo	corni_di_canzo
doane_peak	doane_peak
uei-tepui	uei-tepui
gommolli_kanda	gommolli_kanda
carter_dome	carter_dome
pizzo_di_gino	pizzo_di_gino
mount_ashwood	mount_ashwood
kunturkunka	kunturkunka
olancha_peak	olancha_peak
mckenzie_mountain	mckenzie_mountain
calar_alto	calar_alto
y_mountain	y_mountain
imja_tse	imja_tse
liebenerspitze	liebenerspitze
trischman_knob	trischman_knob
jabal_al_alam	jabal_al_alam
piz_minschuns	piz_minschuns
haukefjellet	haukefjellet
presolana	presolana
hintereisspitzen	hintereisspitzen
colombian_massif	colombian_massif
craig_cerrig-gleisiad	craig_cerrig-gleisiad
piz_lad	piz_lad
falknis	falknis
mount_beerwah	mount_beerwah
equinox_mountain	equinox_mountain
monte_millifret	monte_millifret
mount_fray	mount_fray
cusseta_mountain	cusseta_mountain
urevassnutene	urevassnutene
jack_mountain	jack_mountain
pocumtuck_mountain	pocumtuck_mountain
buttercup_mountain	buttercup_mountain
ben_bhraggie	ben_bhraggie
grintovec	grintovec
mount_suckling	mount_suckling
mcconnell_peak	mcconnell_peak
ifinger	ifinger
corno_campascio	corno_campascio
gallt_yr_ogof	gallt_yr_ogof
mweelrea	mweelrea
big_four_mountain	big_four_mountain
grawand	grawand
chakragil	chakragil
fergana_range	fergana_range
zambales_mountains	zambales_mountains
aouille_tseuque	aouille_tseuque
mount_burman	mount_burman
estelle_mountain	estelle_mountain
hohe_weisse	hohe_weisse
mcknight_mountain	mcknight_mountain
pauhunri	pauhunri
monte_novegno	monte_novegno
lantern_pike	lantern_pike
pangaion_hills	pangaion_hills
mount_pangasugan	mount_pangasugan
aiguille_du_midi	aiguille_du_midi
moel_fferna	moel_fferna
mount_avalon	mount_avalon
double_mountain_(california)	double_mountain_(california)
antimony_peak	antimony_peak
mount_tom_taylor	mount_tom_taylor
deoktaesan	deoktaesan
planjava	planjava
punta_sommeiller	punta_sommeiller
devil's_garden_volcanic_field	devil's_garden_volcanic_field
cherpuk_group	cherpuk_group
aiguille_verte	aiguille_verte
tavan_bogd	tavan_bogd
grandfather_mountain	grandfather_mountain
croaghaun	croaghaun
brian_head_peak	brian_head_peak
pfeifferhorn	pfeifferhorn
larcom_mountain	larcom_mountain
kennebago_divide	kennebago_divide
houvenkopf_mountain	houvenkopf_mountain
gran_sasso_d'italia	gran_sasso_d'italia
aiguille_du_chardonnet	aiguille_du_chardonnet
wynn_mountain	wynn_mountain
chopok	chopok
serra_imeri	serra_imeri
monte_gavia	monte_gavia
buckner_mountain	buckner_mountain
chilhowee_mountain	chilhowee_mountain
mount_bellenden_ker	mount_bellenden_ker
monte_madonnino	monte_madonnino
asacha	asacha
coburn_hill	coburn_hill
eagle_plume_mountain	eagle_plume_mountain
black_pine_peak	black_pine_peak
ambang	ambang
vly_mountain	vly_mountain
aneto	aneto
friday_mountain	friday_mountain
mount_tondano	mount_tondano
monte_rua	monte_rua
san_felipe_volcanic_field	san_felipe_volcanic_field
cerro_noroeste	cerro_noroeste
marmontana	marmontana
donald's_hill	donald's_hill
arklow_hill	arklow_hill
alvand	alvand
monte_granero	monte_granero
coma_del_clot	coma_del_clot
banyabong	banyabong
langeberg	langeberg
midnight_sun_peak	midnight_sun_peak
jabal_ajla	jabal_ajla
sylan	sylan
monte_zevola	monte_zevola
yatsugatake_mountains	yatsugatake_mountains
cerro_alto_mountain	cerro_alto_mountain
red_kaweah	red_kaweah
puntay_urqu	puntay_urqu
east_flattop_mountain	east_flattop_mountain
francs_peak	francs_peak
kula_kangri	kula_kangri
khumbutse	khumbutse
engelberger_rotstock	engelberger_rotstock
cahuenga_peak	cahuenga_peak
mont_caro	mont_caro
mount_wade	mount_wade
jannu	jannu
tomort	tomort
mount_muir	mount_muir
fan_brycheiniog	fan_brycheiniog
cima_valmora	cima_valmora
omplos	omplos
santa_fe_baldy	santa_fe_baldy
missouri_mountain	missouri_mountain
spitzmeilen	spitzmeilen
carstensz_east	carstensz_east
chongtar_kangri	chongtar_kangri
prospectors_mountain	prospectors_mountain
tarnica	tarnica
springer_mountain	springer_mountain
iyang-argapura	iyang-argapura
pic_de_jallouvre	pic_de_jallouvre
mont_mort	mont_mort
lhotse	lhotse
maja_e_papingut	maja_e_papingut
camp_15_peak	camp_15_peak
porter_mountain	porter_mountain
pic_de_noucreus	pic_de_noucreus
mount_paiko	mount_paiko
vulcan_(volcano)	vulcan_(volcano)
monte_penice	monte_penice
gitschberg	gitschberg
qullqip'ukru	qullqip'ukru
mount_kinabalu	mount_kinabalu
monturull	monturull
monte_costone	monte_costone
corn_du	corn_du
army_peak	army_peak
pierian_mountains	pierian_mountains
mont_ouzon	mont_ouzon
kupunkamint_mountain	kupunkamint_mountain
mount_ogden	mount_ogden
thunderbolt_peak	thunderbolt_peak
south_kings_peak	south_kings_peak
mount_frink	mount_frink
buckden_pike	buckden_pike
puigsacalm	puigsacalm
monte_cinto_(colli_euganei)	monte_cinto_(colli_euganei)
wank_(mountain)	schmausenbuck
wank_(mountain)	hoher_fricken
ben_gorm	ben_gorm
mont_orchez	mont_orchez
tonelagee	tonelagee
peak_2266	peak_2266
mount_stanley	mount_stanley
alexandra_peak	alexandra_peak
tre_cime_di_lavaredo	tre_cime_di_lavaredo
baikal_mountains	baikal_mountains
hillsboro_gap	hillsboro_gap
langebottfjellet	langebottfjellet
jervvasstind	jervvasstind
saldurspitze	saldurspitze
mola_dels_quatre_termes	mola_dels_quatre_termes
monte_sasso	monte_sasso
mount_san_antonio	mount_san_antonio
grande_rocheuse	grande_rocheuse
angora_peak	angora_peak
monte_rusta	monte_rusta
aran_fawddwy	aran_fawddwy
bifertenstock	bifertenstock
arabia_mountain	arabia_mountain
la_tossa	la_tossa
admonter_reichenstein	admonter_reichenstein
pre-pyrenees	pre-pyrenees
nanda_gond	nanda_gond
rising_wolf_mountain	rising_wolf_mountain
mount_mulu	mount_mulu
sant_miquel_de_solterra	sant_miquel_de_solterra
mount_fridtjof_nansen	mount_fridtjof_nansen
ongal_peak	ongal_peak
pointe_de_chavasse	pointe_de_chavasse
mount_tambuyukon	mount_tambuyukon
ngga_pilimsit	ngga_pilimsit
fan_gyhirych	fan_gyhirych
mount_guiting-guiting	mount_guiting-guiting
jesse_morrow_mountain	jesse_morrow_mountain
great_blue_hill	great_blue_hill
bristen	bristen
pic_de_freser	pic_de_freser
monte_martica	monte_martica
monte_nudo	monte_nudo
mount_ouray	mount_ouray
mount_ansel_adams	mount_ansel_adams
titiwangsa_mountains	titiwangsa_mountains
pizzo_di_zocca	pizzo_di_zocca
mount_majura	mount_majura
pointe_des_grands	pointe_des_grands
manzano_peak	manzano_peak
abert_rim	abert_rim
reynolds_mountain	reynolds_mountain
pizzo_san_michele	pizzo_san_michele
bastille_peak	bastille_peak
mount_nukap	mount_nukap
dollarhide_mountain	dollarhide_mountain
annapurna_sanctuary	annapurna_sanctuary
mont_billiat	mont_billiat
island_park_caldera	island_park_caldera
oslyanka	oslyanka
harridge_pike	harridge_pike
mount_athelstan	mount_athelstan
pizzo_dei_tre_confini	pizzo_dei_tre_confini
mount_shungol	mount_shungol
les_borregues	les_borregues
luossavaara	luossavaara
yr_eifl	yr_eifl
cesen	cesen
mount_mangengenge	mount_mangengenge
blood_mountain	blood_mountain
rittner_horn	rittner_horn
craig_eigiau	craig_eigiau
borestone_mountain	borestone_mountain
mount_drum	mount_drum
antler_peak	antler_peak
victoria_peak	victoria_peak
heavens_peak	heavens_peak
mount_data	mount_data
wolseongbong	wolseongbong
phou_pha_thi	phou_pha_thi
mount_vineuo	mount_vineuo
mount_nora	mount_nora
mount_van_hoevenberg	mount_van_hoevenberg
beinn_odhar	beinn_odhar
musala	musala
aden_crater	aden_crater
mount_marcus_baker	mount_marcus_baker
dry_ridge_mountain	dry_ridge_mountain
seonunsan	seonunsan
piz_chaschauna	piz_chaschauna
going-to-the-sun_mountain	going-to-the-sun_mountain
mount_garmo	mount_garmo
jetnamsklumpen	jetnamsklumpen
doublet_peak	doublet_peak
north_gardner_mountain	north_gardner_mountain
twilight_peak	twilight_peak
kirat_chuli	kirat_chuli
shining_rock	shining_rock
mad_wolf_mountain	mad_wolf_mountain
tat_ali	tat_ali
du_toits_peak	du_toits_peak
imogene_peak	imogene_peak
notch_peak	notch_peak
pu'u'oke'oke'o	pu'u'oke'oke'o
blanca_peak	blanca_peak
mount_chocorua	mount_chocorua
eden_mountain	eden_mountain
guye_peak	guye_peak
catoctin_mountain	catoctin_mountain
chugach_mountains	chugach_mountains
long_ridge_(san_mateo_county,_california)	long_ridge_(san_mateo_county,_california)
crampton's_gap	crampton's_gap
dinglishna_hill	dinglishna_hill
mount_tirad	mount_tirad
lose_hill	lose_hill
hough_peak	hough_peak
palisade_crest	palisade_crest
veten	veten
yala_peak	yala_peak
wolverine_peak	wolverine_peak
donaldson_peak	donaldson_peak
abakan_range	abakan_range
horse_ranch_mountain	horse_ranch_mountain
san_gabriel_peak	san_gabriel_peak
monte_chiusarella	monte_martica
monte_chiusarella	monte_chiusarella
aiguille_des_grands_montets	aiguille_des_grands_montets
sas_dles_diesc	sas_dles_diesc
croseus_peak	croseus_peak
crested_butte	crested_butte
minarets_(california)	minarets_(california)
chiquito_peak	chiquito_peak
mount_cordeaux	mount_cordeaux
bunya_mountains	bunya_mountains
mount_wire	mount_wire
wissigstock	wissigstock
montmeneu	montmeneu
lone_walker_mountain	lone_walker_mountain
mount_labo	mount_labo
black_butte_(siskiyou_county,_california)	black_butte_(siskiyou_county,_california)
divide_mountain	divide_mountain
middle_cathedral_rock	middle_cathedral_rock
erbeskopf	erbeskopf
mount_charleston	mount_charleston
mount_pulag	mount_pulag
san_mateo_peak	san_mateo_peak
kuhe_haji_ebrahim	kuhe_haji_ebrahim
stacks_bluff	stacks_bluff
mount_paris	mount_paris
gross_bielenhorn	gross_bielenhorn
zigerbergkopf	zigerbergkopf
hyndman_peak	hyndman_peak
trilobite_point	trilobite_point
corno_guazza	corno_guazza
sze_fong_shan	sze_fong_shan
alaska_range	alaska_range
an_gearanach	an_gearanach
hart_mountain	hart_mountain
porche_di_vallinfante	porche_di_vallinfante
mount_bendeleben	mount_bendeleben
mus-khaya_mountain	mus-khaya_mountain
foel_grach	foel_grach
velika_kapela	velika_kapela
piz_buin_pitschen	piz_buin_pitschen
grossglockner	grossglockner
piz_ault	piz_ault
barn_bluff	barn_bluff
cefn_yr_ystrad	cefn_yr_ystrad
mount_mcdowell	mount_mcdowell
kendrick_peak	kendrick_peak
mount_yamin	mount_yamin
limestack_mountain	limestack_mountain
brush_mountain_(kern_county,_california)	brush_mountain_(kern_county,_california)
nirekha	nirekha
haunold	haunold
tumbledown_mountain	tumbledown_mountain
cerro_ciento	cerro_ciento
mount_yumiori	mount_yumiori
mount_malaueg	mount_malaueg
kahiltna_dome	kahiltna_dome
roualle	roualle
piz_da_l'acqua	piz_da_l'acqua
fan_nedd	fan_nedd
cime_di_val_loga	cime_di_val_loga
lauvkollen	lauvkollen
piz_dal_teo	piz_dal_teo
pointe_d'ireuse	pointe_d'ireuse
monte_galbiga	monte_galbiga
gurla_mandhata	gurla_mandhata
south_teton	south_teton
tsiteli_khati	tsiteli_khati
zla_kolata	zla_kolata
watkins_range	watkins_range
suswa	suswa
pontic_mountains	pontic_mountains
mount_coree	mount_coree
mount_mcbride	mount_mcbride
mount_saint_john	mount_saint_john
hartshead_pike	hartshead_pike
skammevarden	skammevarden
monte_massico	monte_massico
trocon	trocon
piz_cancian	piz_cancian
monte_barro	monte_barro
columbia_peak	columbia_peak
erta_ale	erta_ale
piz_badile	piz_badile
druid_peak	druid_peak
les_perrons	les_perrons
muryongsan	muryongsan
hartmannswillerkopf	hartmannswillerkopf
cima_del_serraglio	cima_del_serraglio
rays_hill	rays_hill
vardousia	vardousia
chli_spannort	chli_spannort
monte_budellone	monte_budellone
payun_matru	payun_matru
wase_rock	wase_rock
taburnus	taburnus
mount_tarawera	mount_tarawera
creach_bheinn	creach_bheinn
lushaugen	lushaugen
mount_pilchuck	mount_pilchuck
thornton_peak	thornton_peak
piz_umbrail	piz_umbrail
saint_john_mountain_(california)	saint_john_mountain_(california)
dragmarpo_ri	dragmarpo_ri
mount_passaconaway	mount_passaconaway
hurst_hill	hurst_hill
mount_helicon	mount_helicon
shiprock	shiprock
monte_mars	monte_mars
cyrniau_nod	cyrniau_nod
cima_del_rosso	cima_del_rosso
monte_acero	monte_acero
borah_peak	borah_peak
munt_cotschen	munt_cotschen
mercedario	mercedario
oxford_mountain	oxford_mountain
picos_de_europa	picos_de_europa
puig_estela	puig_estela
mount_blackwood	mount_blackwood
skrzyczne	skrzyczne
mount_gingera	mount_gingera
njesuthi	njesuthi
aiguille_blanche_de_peuterey	aiguille_blanche_de_peuterey
colle_di_brianza	colle_di_brianza
gran_paradiso	gran_paradiso
sighignola	sighignola
golovnin	golovnin
rogla	rogla
great_hill	great_hill
puigmal	puigmal
mahtotopa_mountain	mahtotopa_mountain
great_whernside	great_whernside
jabal_yibir	jabal_yibir
clinch_mountain	clinch_mountain
monte_disgrazia	monte_disgrazia
barlow_peak	barlow_peak
bache_hill	bache_hill
muztagh_ata	muztagh_ata
belianske_tatras	belianske_tatras
alay_mountains	alay_mountains
monte_rotondo_(monti_sibillini)	monte_rotondo_(monti_sibillini)
penibaetic_system	penibaetic_system
mount_judson	mount_judson
wichita_mountains	wichita_mountains
laguna_caldera	laguna_caldera
tour_noir	tour_noir
monte_molaro	monte_molaro
balsam_cap	balsam_cap
skreikampen	skreikampen
jabal_haqamah	jabal_haqamah
paps_of_anu	paps_of_anu
trout_creek_hill	trout_creek_hill
tonoloway_ridge	tonoloway_ridge
cumberland_narrows	cumberland_narrows
monte_montiego	monte_montiego
moldo_too	moldo_too
hulubelu	hulubelu
mount_madison	mount_madison
kwaduma	kwaduma
gra_de_fajol	gra_de_fajol
monte_generoso	monte_generoso
moel_ysgyfarnogod	foel_penolau
mitsikeli	mitsikeli
manbokdae	manbokdae
aiguille_de_leschaux	aiguille_de_leschaux
mount_langley	mount_langley
gamburtsev_mountain_range	gamburtsev_mountain_range
north_franklin_mountain	north_franklin_mountain
selbsanft	selbsanft
ohrenspitzen	ohrenspitzen
mont_avril	mont_avril
pumori	pumori
bwlch_y_ddwyallt	bwlch_y_ddwyallt
akademiya_nauk_range	akademiya_nauk_range
vesole	vesole
warrior_mountain	warrior_mountain
mount_baden-powell	mount_baden-powell
ganboa	ganboa
mount_tibrogargan	mount_tibrogargan
rotspitz	rotspitz
changtse	changtse
lendfjellet	lomseggi
mont_veyrier	mont_veyrier
buyu_balease	buyu_balease
illaksan	illaksan
pic_de_serra_gallinera	pic_de_serra_gallinera
suj_tilla_east	suj_tilla_east
vertainspitze	vertainspitze
alps	alps
gawler_ranges	gawler_ranges
zuni-bandera_volcanic_field	zuni-bandera_volcanic_field
mount_kemul	mount_kemul
brunnsteinspitze	rotwandlspitze
gross_ruchen	gross_ruchen
vernadskii_ridge	vernadskii_ridge
hayden_mountain_(oregon)	hayden_mountain_(oregon)
stiperstones	stiperstones
campbell_mountain	campbell_mountain
o'a_caldera	o'a_caldera
jabal_dad	jabal_dad
petrohan_pass	petrohan_pass
palasip_qaqqaa	palasip_qaqqaa
mount_schurz	mount_schurz
zurn_peak	zurn_peak
slieve_snaght	slieve_snaght
qutuni	qutuni
nahsukin_mountain	nahsukin_mountain
walbury_hill	walbury_hill
turlough_hill	turlough_hill
pen_llithrig_y_wrach	pen_llithrig_y_wrach
seodaesan	seodaesan
traveler_mountain	traveler_mountain
formosa_peak	formosa_peak
cardamom_hills	cardamom_hills
ostredok	ostredok
apple_orchard_mountain	apple_orchard_mountain
baegambong	baegambong
grindslow_knoll	grindslow_knoll
mount_monadnock	mount_monadnock
aleutian_range	aleutian_range
scioscia	scioscia
mount_kirkpatrick	mount_kirkpatrick
salzachgeier	salzachgeier
jabal_ghina	jabal_ghina
cribarth	cribarth
mount_liszt	mount_liszt
tordrillo_mountains	tordrillo_mountains
tabeguache_peak	tabeguache_peak
orjen	orjen
mount_stephenson	mount_stephenson
pollino	pollino
jabal_sha'ra	jabal_sha'ra
elgheia	elgheia
mount_kulal	mount_kulal
serra_calderona	serra_calderona
little_sugar_loaf	little_sugar_loaf
nea_kameni	nea_kameni
beautiful_mountain	beautiful_mountain
pic_de_la_fossa_del_gegant	pic_de_la_fossa_del_gegant
mandallaz_mountain	mandallaz_mountain
gable_mountain	gable_mountain
grays_peak	grays_peak
schwemser_spitze	schwemser_spitze
nippletop	nippletop
djupeskardnosi	djupeskardnosi
mount_pendan	mount_pendan
hochgall	hochgall
jbel_ayachi	jbel_ayachi
kostakan	kostakan
monte_galero	monte_galero
mount_nif	mount_nif
matty_price_hill	matty_price_hill
gunstock_mountain	gunstock_mountain
wissberg	wissberg
black_crescent_mountain	black_crescent_mountain
pothole_dome	pothole_dome
blue_ridge_mountains	blue_ridge_mountains
lone_peak	lone_peak
mount_berlin	mount_berlin
amboy_crater	amboy_crater
stokes_mountain	stokes_mountain
snowshoe_peak	snowshoe_peak
snickers_gap	snickers_gap
mount_woodring	mount_woodring
piz_cazarauls	piz_cazarauls
jabal_rumh	jabal_rumh
noric_alps	noric_alps
lizard_head	lizard_head
chrome_hill	chrome_hill
hoher_randen	hornberg_(dautphetal)
aiguilles_du_diable	aiguilles_du_diable
cardinal_peak	cardinal_peak
lenkstein	lenkstein
kibara_mountains	kibara_mountains
maladeta	maladeta
namarunu	namarunu
simeon_peak	simeon_peak
kleiner_wurzelnberg	kleiner_wurzelnberg
mount_mcquillan	mount_mcquillan
mount_olympus	mount_olympus
sierra_de_enguera	sierra_de_enguera
glassford_peak	glassford_peak
monte_velino	monte_velino
paithalmala	paithalmala
hestebottnuten	hestebottnuten
shir_kuh	shir_kuh
trakta	trakta
karmutzen_mountain	karmutzen_mountain
st._boris_peak	st._boris_peak
wallface_mountain	wallface_mountain
tehachapi_pass	tehachapi_pass
matajur	matajur
skurvefjellet	skurvefjellet
kebnekaise	kebnekaise
hapush_mountain	hapush_mountain
storebottnosi	storebottnosi
montegordo	montegordo
asralt_khairkhan	asralt_khairkhan
black_chew_head	black_chew_head
clouds_rest	clouds_rest
boardman_peak	boardman_peak
aiguille_des_angroniettes	aiguille_des_angroniettes
north_moat_mountain	north_moat_mountain
mount_siple	mount_siple
mont_de_boisy	mont_de_boisy
cantabrian_mountains	cantabrian_mountains
karpinsky_group	karpinsky_group
siguang_ri	siguang_ri
matterhorn_peak	matterhorn_peak
craig_cwm_silyn	craig_cwm_silyn
umiasussuk	umiasussuk
pointe_d'andey	pointe_d'andey
tyee_mountain	tyee_mountain
monte_cridola	monte_cridola
joseph_peak	joseph_peak
elsinore_peak	elsinore_peak
mont_glacier	mont_glacier
blake_peak	blake_peak
mount_dzhimara	mount_dzhimara
mount_nittany	mount_nittany
nez_perce_peak	nez_perce_peak
monte_tabor_(recanati)	monte_tabor_(recanati)
lenin_peak	lenin_peak
gray_wolf_pass	gray_wolf_pass
monte_volturino	monte_volturino
monte_venda	monte_venda
baker_peak	baker_peak
meru_peak	meru_peak
vinson_massif	vinson_massif
nattaung	nattaung
tenasserim_hills	tenasserim_hills
trio_mountain	trio_mountain
cleaver_peak	cleaver_peak
montalt	montalt
monte_clapier	monte_clapier
kadifekale	kadifekale
mount_sannomine	mount_sannomine
lost_river_peak	lost_river_peak
rahle_godle	rahle_godle
noshaq	noshaq
mount_fairweather	mount_fairweather
leinenosi	leinenosi
kiekeberg	kiekeberg
grigna	grigna
grigna	monte_san_martino_(lecco)
margarita_peak	margarita_peak
mount_narodnaya	mount_narodnaya
cerro_de_la_neblina	cerro_de_la_neblina
cat_hills_volcanic_field	cat_hills_volcanic_field
payette_peak	payette_peak
shah_dhar	shah_dhar
les_droites	les_droites
tofane	tofane
gasherbrum_ii	gasherbrum_ii
peitlerkofel	peitlerkofel
mount_evans	mount_evans
roc_d'enfer	roc_d'enfer
chopaka_mountain	chopaka_mountain
schneebiger_nock	schneebiger_nock
dhaulagiri	dhaulagiri
rocca_pendice	rocca_pendice
dente_di_coca	dente_di_coca
monte_vettore	monte_vettore
gregory_bald	gregory_bald
mulayit_taung	mulayit_taung
henry_mountains	henry_mountains
ulu_titi_basah	ulu_titi_basah
chappal_waddi	chappal_waddi
qur_al_rikibi	qur_al_rikibi
grandes_jorasses	grandes_jorasses
killington_peak	killington_peak
denti_della_vecchia	denti_della_vecchia
lonesome_lake_peak	lonesome_lake_peak
bouquetins	bouquetins
monte_lesima	monte_lesima
nicholson_peak	nicholson_peak
el_sui	el_sui
ben_tee	ben_tee
sierra_grande	sierra_grande
breitentalskopf	breitentalskopf
pochuck_mountain	pochuck_mountain
tarren_y_gesail	tarren_y_gesail
storkenkopf	storkenkopf
mount_kjerringa	mount_kjerringa
poncione_d'arzo	poncione_d'arzo
palon_de_la_mare	palon_de_la_mare
gasherbrum_iv	gasherbrum_iv
pegasus_peak	pegasus_peak
una_peaks	una_peaks
north_dome	north_dome
baboso	baboso
wildkogel	wildkogel
monte_colombine	monte_colombine
muztagh_tower	muztagh_tower
holyhead_mountain	holyhead_mountain
gehrdener_berg	gehrdener_berg
flinsch_peak	flinsch_peak
broad_peak	broad_peak
qiajivik_mountain	qiajivik_mountain
mount_nuang	mount_nuang
ocate_peak	ocate_peak
mount_con_reid	mount_con_reid
popsicle_peak	popsicle_peak
czarna_kopa	czarna_kopa
abuye_meda	abuye_meda
piz_de_setag	piz_de_setag
mount_huckle	mount_huckle
pen_yr_ole_wen	pen_yr_ole_wen
kakshaal_too	kakshaal_too
ahern_peak	ahern_peak
mount_constance	mount_constance
maesglase	maesglase
pilot_hill	pilot_hill
mont_avic	mont_avic
lusatian_highlands	lusatian_highlands
giant's_castle	giant's_castle
mount_elden	mount_elden
mount_siyeh	mount_siyeh
mount_lemmon	mount_lemmon
bat_khan_mountain	bat_khan_mountain
vrashka_chuka	vrashka_chuka
hell's_half_acre_lava_field	hell's_half_acre_lava_field
cumberland_gap	cumberland_gap
fairview_dome	fairview_dome
campgaw_mountain	campgaw_mountain
kerkis	kerkis
craig_y_llyn	craig_y_llyn
crest_mountain	crest_mountain
mount_superbus	mount_superbus
jacks_knob	jacks_knob
sarik-gajah	sarik-gajah
jabal_safad	jabal_safad
baugh_fell	baugh_fell
kundudo	kundudo
shere_hills	shere_hills
chwarel_y_fan	chwarel_y_fan
north_brother	north_brother
monte_argentella	monte_argentella
stadelhorn	stadelhorn
glatthorn	glatthorn
panchchuli	panchchuli
caucasus_mountains	caucasus_mountains
mont_maudit	mont_maudit
jabal_al_huwaybit	jabal_al_huwaybit
kassianspitze	kassianspitze
brooks_mountain	brooks_mountain
piz_varuna	piz_varuna
gross_schinhorn	gross_schinhorn
mount_bangeta	mount_bangeta
kvasstinden	kvasstinden
phillips_ridge	phillips_ridge
mutzenberg	mutzenberg
ranger_peak	ranger_peak
gjallica	gjallica
giewont	giewont
coosa_bald	coosa_bald
shaheeya_peak	shaheeya_peak
monte_lieto	monte_lieto
mount_vx-6	mount_vx-6
red_mountain_(glacier_county,_montana)	red_mountain_(glacier_county,_montana)
concord_peak	concord_peak
titterstone_clee_hill	titterstone_clee_hill
klofjell	klofjell
oppskott	oppskott
scar_ridge	scar_ridge
eggella	eggella
monte_colma	monte_colma
axe_edge_moor	axe_edge_moor
crestone_peak	crestone_peak
yongbongsan	yongbongsan
storsnasen	storsnasen
raynolds_peak	raynolds_peak
ipf_(mountain)	kleiner_seekopf
oat_mountain_(california)	oat_mountain_(california)
el_montmajor	el_montmajor
auts	auts
mount_biederbick	mount_biederbick
piz_miez	piz_miez
kosvinsky_kamen	kosvinsky_kamen
piz_scerscen	piz_scerscen
schonchin_butte	schonchin_butte
jabal_umm_al-farfar	jabal_umm_al-farfar
monte_farno	monte_farno
nevado_queva	nevado_queva
tossal_de_la_baltasana	tossal_de_la_baltasana
serra_d'en_galceran	serra_d'en_galceran
deogyusan	deogyusan
pizzo_centrale	pizzo_centrale
aj_bogd	aj_bogd
tilicho_peak	tilicho_peak
foel-fras	foel-fras
monte_torena	monte_torena
polveracchio	polveracchio
quilotoa	quilotoa
saharan_atlas	saharan_atlas
folsom_peak	folsom_peak
kawagarbo	kawagarbo
werneth_low	werneth_low
piz_serra	piz_serra
mount_friesland	mount_friesland
mount_thelwood	mount_thelwood
back_allegheny_mountain	back_allegheny_mountain
mount_doongal	mount_doongal
pizzo_coca	pizzo_coca
san_jacinto_peak	san_jacinto_peak
spechhorn	spechhorn
double_peak_(san_diego_county,_california)	double_peak_(san_diego_county,_california)
gorfion	gorfion
owl_mountains	owl_mountains
mont_blanc_du_tacul	mont_blanc_du_tacul
mount_ethelwulf	mount_ethelwulf
saviers_peak	saviers_peak
mariner_mountain	mariner_mountain
aiguille_du_jardin	aiguille_du_jardin
cordillera_de_la_ramada	cordillera_de_la_ramada
mickle_fell	mickle_fell
vigiljoch	vigiljoch
serra_del_tallat	serra_del_tallat
jabal_qurayyah	jabal_qurayyah
campo_dei_fiori_di_varese	campo_dei_fiori_di_varese
mount_deborah	mount_deborah
pen_yr_helgi_du	pen_yr_helgi_du
namcha_barwa	namcha_barwa
farley_mount	farley_mount
beskids	beskids
rosengartenspitze	rosengartenspitze
sass_de_stria	sass_de_stria
wolfpen_ridge	wolfpen_ridge
aspen_butte	aspen_butte
verno	verno
stuchd_an_lochain	stuchd_an_lochain
pico_posets	pico_posets
svilaja	svilaja
monte_talvena	monte_talvena
pik_bam	pik_bam
strondefjell	strondefjell
conococheague_mountain	conococheague_mountain
great_western_tiers	great_western_tiers
south_branch_mountain	south_branch_mountain
himalchuli	himalchuli
mount_london	mount_london
gunung_lambak	gunung_lambak
monte_igno	monte_igno
truchas_peak	truchas_peak
miche_wabun_peak	miche_wabun_peak
navesink_highlands	navesink_highlands
ralston_peak	ralston_peak
serra_di_castrocucco	serra_di_castrocucco
curecanti_needle	curecanti_needle
morro_solar	morro_solar
weets_hill	weets_hill
monte_cistella	monte_cistella
plasteikopf	plasteikopf
horsetooth_mountain	horsetooth_mountain
sheep_mountain_(flathead_county,_montana)	sheep_mountain_(flathead_county,_montana)
wacousta_hill	wacousta_hill
mount_bross	mount_bross
mount_zagora	mount_zagora
lomonosov_group	lomonosov_group
monte_ripalta	monte_ripalta
svarvarnuten	svarvarnuten
pico_das_agulhas_negras	pico_das_agulhas_negras
piz_della_forcola	piz_della_forcola
the_sawtooth	the_sawtooth
nairamdal_peak	nairamdal_peak
menengai	menengai
jabal_fariq	jabal_fariq
mount_devoe	mount_devoe
arabakonak	arabakonak
pizzo_di_porcaresc	pizzo_di_porcaresc
puig_de_la_collada_verda	puig_de_la_collada_verda
mount_bonython	mount_bonython
meesenkopf	meesenkopf
tell_atlas	tell_atlas
luggala	luggala
langspitz	langspitz
klein_grieshorn	klein_grieshorn
mount_dana	mount_dana
sierra_de_las_nieves	sierra_de_las_nieves
sara_sara	sara_sara
oberalpstock	oberalpstock
outeniqua_mountains	outeniqua_mountains
mount_ginini	mount_ginini
phu_ruea	phu_ruea
klitsa_mountain	klitsa_mountain
favor_peak	favor_peak
little_chief_mountain	little_chief_mountain
spaulding_mountain	spaulding_mountain
crug_mawr	crug_mawr
klein_furkahorn	klein_furkahorn
zufrittspitze	zufrittspitze
carnedd_y_ddelw	carnedd_y_ddelw
mount_thor	mount_thor
mont_joly	mont_joly
burgberg_(schauenburg)	laufskopf
high_tatras	high_tatras
monte_faito	monte_faito
old_hyndman_peak	old_hyndman_peak
mount_allison	mount_allison
jabal_shi'ab_ash_shaybah	jabal_shi'ab_ash_shaybah
jordan_craters	jordan_craters
blacktail_butte	blacktail_butte
pic_del_segre	pic_del_segre
matahpi_peak	matahpi_peak
double_spring_knob	double_spring_knob
monte_sobretta	monte_sobretta
wilder_freiger	wilder_freiger
hochtor	hochtor
roque_de_agando	roque_de_agando
mount_watatic	mount_watatic
montgomery_peak	montgomery_peak
monte_ceva	monte_ceva
pik_tandykul	pik_tandykul
la_cogulla_(figuerola_del_camp)	la_cogulla_(figuerola_del_camp)
skuta	skuta
cherangani_hills	cherangani_hills
cuilcagh	cuilcagh
allt_lwyd	allt_lwyd
skoddenosi	skoddenosi
kinder_scout	kinder_scout
hole_in_the_mountain_peak	hole_in_the_mountain_peak
unjangsan	unjangsan
ben_ledi	ben_ledi
frozen_head	frozen_head
standhope_peak	standhope_peak
pedraforca	pedraforca
goldlochspitz	goldlochspitz
raton-clayton_volcanic_field	raton-clayton_volcanic_field
nanda_devi	nanda_devi
mount_pangulubao	mount_pangulubao
el_moixer	el_moixer
tumalo_mountain	tumalo_mountain
santa_clara_volcano	santa_clara_volcano
turnerkamp	turnerkamp
gannett_peak	gannett_peak
mount_custer	mount_custer
seongsusan	seongsusan
bunsen_peak	bunsen_peak
pointe_de_nyon	pointe_de_nyon
puig_de_la_mola	puig_de_la_mola
nasa_mountain	nasa_mountain
elivai_malai	elivai_malai
mount_wilbur_(montana)	mount_wilbur_(montana)
valamara	valamara
pizzo_campanile	pizzo_campanile
mount_redington	mount_redington
phou_bia	phou_bia
devon_ice_cap	devon_ice_cap
monte_rosso_(colli_euganei)	monte_rosso_(colli_euganei)
lo_corrunco	lo_corrunco
pico_das_torres	pico_das_torres
mount_sahendaruman	mount_sahendaruman
mount_nyenchen_tanglha	mount_nyenchen_tanglha
longs_peak	longs_peak
scandinavian_mountains	scandinavian_mountains
mount_bromo	mount_bromo
salt_pond_mountain	salt_pond_mountain
mount_bower	mount_bower
church_mountain	church_mountain
double_butte	double_butte
earth_peoples_park	earth_peoples_park
coso_volcanic_field	coso_volcanic_field
ear_mountain	ear_mountain
thierberg	thierberg
jenny_jump_mountain	jenny_jump_mountain
toohey_mountain	toohey_mountain
mount_pugh	mount_pugh
mount_benarat	mount_benarat
kvarkush	kvarkush
garraf_massif	garraf_massif
grain_pole_hill	grain_pole_hill
hedges_peak	hedges_peak
blinnenhorn	blinnenhorn
tulymsky_kamen	tulymsky_kamen
wachwa	wachwa
poor_mountain	poor_mountain
mount_weeks	mount_weeks
maly_payalpan	maly_payalpan
ruchstock	ruchstock
mullaghcarn	mullaghcarn
rockfish_gap	rockfish_gap
big_jay	big_jay
pomagagnon	pomagagnon
transantarctic_mountains	transantarctic_mountains
speckled_mountain	speckled_mountain
mount_royal	mount_royal
camelback_mountain	camelback_mountain
rendezvous_mountain	rendezvous_mountain
mount_korab	mount_korab
latsga	latsga
half_dome	half_dome
morro_da_igreja	morro_da_igreja
hayli_gubbi	hayli_gubbi
monte_cimone_di_tonezza	monte_cimone_di_tonezza
shining_tor	shining_tor
mount_filberg	mount_filberg
el_negrell	el_negrell
chomo_lonzo	chomo_lonzo
sant_amand	sant_amand
bamboesberg	bamboesberg
rigny_bjerg	rigny_bjerg
fusillade_mountain	fusillade_mountain
dukono	dukono
ebeko	ebeko
piz_cengalo	piz_cengalo
pelion	pelion
pryor_mountains	pryor_mountains
rocca_la_meja	rocca_la_meja
grozny_group	grozny_group
camel's_hump	camel's_hump
makalu	makalu
mount_korbu	mount_korbu
langkofel	langkofel
jabal_'aqqah	jabal_'aqqah
dent_de_cons	dent_de_cons
white_cloud_peak_10	white_cloud_peak_10
wakrish	wakrish
langtang_lirung	langtang_lirung
roen	roen
mount_ellis	mount_ellis
rubicon_peak	rubicon_peak
rubicon_peak	rooster_comb
electric_peak	electric_peak
cathedral_peak_(california)	cathedral_peak_(california)
cadair_berwyn_north_top	cadair_berwyn_north_top
stob_choire_claurigh	stob_choire_claurigh
albrun_pass	albrun_pass
mother_cummings_peak	mother_cummings_peak
jabal_badiyah	jabal_badiyah
rivington_pike	rivington_pike
blackmon_peak	blackmon_peak
cajon_pass	cajon_pass
sex_du_coeur	sex_du_coeur
koraspitz	koraspitz
birnhorn	birnhorn
pizzo_formico	pizzo_formico
monte_antola	monte_antola
sass_de_mura	sass_de_mura
melette	melette
pidurutalagala	pidurutalagala
big_den_mountain	big_den_mountain
hurricane_mountain	hurricane_mountain
nuptse	nuptse
nevado_tres_cruces	nevado_tres_cruces
wielka_sowa	wielka_sowa
mount_sempu	mount_sempu
mount_akhun	mount_akhun
mount_dajt	mount_dajt
mount_halcon	mount_halcon
mount_kent-urquhart	mount_kent-urquhart
cage_hill	cage_hill
mount_othrys	mount_othrys
timber_ridge	timber_ridge
barrslievenaroy	barrslievenaroy
mount_pelion_west	mount_pelion_west
wendenhorn	wendenhorn
lagaunspitze	lagaunspitze
sawmill_mountain	sawmill_mountain
the_cheviot	the_cheviot
sandviksfjellet	sandviksfjellet
scheienkopf	scheienkopf
puig_major	puig_major
desert_de_les_palmes	desert_de_les_palmes
adarra	adarra
iii._hornspitze	iii._hornspitze
dreiherrnspitze	dreiherrnspitze
glittertind	glittertind
corno_baitone	corno_baitone
sierra_maestra	sierra_maestra
glen_coe	glen_coe
mount_hermon	mount_hermon
finisterre_range	finisterre_range
drakensberg	drakensberg
shipka_pass	shipka_pass
jakupica	jakupica
belasica	belasica
cahuenga_pass	cahuenga_pass
amba_aradam	amba_aradam
nafusa_mountains	nafusa_mountains
cumberland_gap	cumberland_gap
monterey_pass	monterey_pass
amba_alagi	amba_alagi
takur_ghar	takur_ghar
petrova_gora	petrova_gora
bud_dajo	bud_dajo
hartmannswillerkopf	hartmannswillerkopf
dabie_mountains	dabie_mountains
picos_de_europa	picos_de_europa
mont_mouchet	mont_mouchet
eastern_alps	eastern_alps
hill_of_tara	hill_of_tara
herefordshire_beacon	herefordshire_beacon
tifata	tifata
isandlwana	isandlwana
punta_san_matteo	punta_san_matteo
mount_barbaro	mount_barbaro
apache_pass	apache_pass
