goodnight_moon	goodnight_moon
a_fortress_of_grey_ice	a_fortress_of_grey_ice
an_appeal_to_reason	an_appeal_to_reason
prince_caspian	prince_caspian
old_school_(novel)	old_school_(novel)
all_i_need_is_love	all_i_need_is_love
mountain_cat	mountain_cat
dir_en_grey_yarouze	naoko_(novel)
the_sheep-pig	the_sheep-pig
the_end_of_education	the_end_of_education
the_darien_gap	ahead_of_the_curve
despite_the_falling_snow	the_blood_spilt
the_book_of_animal_ignorance	the_book_of_animal_ignorance
the_virgin_book_of_british_hit_singles	the_virgin_book_of_british_hit_singles
danger_along_the_ohio	tuesdays_with_morrie
hotel_world	hotel_world
ways_to_live_forever	breath_(novel)
buddha_da	buddha_da
flour_babies	flour_babies
here_my_home_once_stood	here_my_home_once_stood
spider_boy_(novel)	spider_boy_(novel)
the_jesus_dynasty	the_jesus_dynasty
the_art_of_the_metaobject_protocol	the_art_of_the_metaobject_protocol
the_turbulent_term_of_tyke_tiler	the_turbulent_term_of_tyke_tiler
aramaya	48_shades_of_brown
death_in_the_clouds	death_in_the_clouds
just_in_case	just_in_case
learning_to_sing	learning_to_sing
